undermining	disobey
half	common_fraction
impersonation	wit
upload	transfer
shooting	propulsion
disapproval	dislike
hall	corridor
idol	effigy
pollution	environmental_condition
pretend	pretense
wreck	decline
tea	beverage
imperfect	tense
drunk	drinker
slaloming	ski
diverges	move
pick	decision_making
installments	payment
doles	share
ten	large_integer
daring	challenge
sake	benefit
pics	product
seamstress	garmentmaker
energy	physical_phenomenon
blasts	fly
spreading	change_of_location
investment	finance
scratch	wound
compassionate	grieve
standards	system_of_measurement
1	digit
2	digit
3	digit
travelogue	attraction
depictions	description
triple	base_hit
4	digit
5	digit
6	digit
7	digit
8	digit
professors	academician
unhinged	disturb
9	digit
rounded	travel
amusing	entertain
jackass	fool
telling	narration
hang	endowment
role	duty
turf	land
vengeance	retaliation
turd	fecal_matter
cliff	geological_formation
roll	rotation
turn	curve
perseverance	determination
ceo	corporate_executive
blond	person
result	phenomenon
gold	precious_metal
ces	metallic_element
rejects	decision_making
golf	outdoor_game
same	european
pies	pastry
wreak	make
positives	adjective
staircase	way
hand	extremity
reigns	time_period
resume	summary
a	metric_linear_unit
ordered	request
b	eubacteria
salt	compound
d	fat-soluble_vitamin
e	antioxidant
f	degree
laden	remove
spiral	curve
h	chemical_element
visualizing	imagine
i	chemical_element
truncated	substitute
j	work_unit
k	temperature_unit
eating	consumption
l	metric_capacity_unit
blood	liquid_body_substance
m	metric_linear_unit
neighbor	person
n	chemical_element
gripping	seize
o	chemical_element
straight	person
p	chemical_element
stasis	pathology
q	letter
entering	change_of_location
r	radioactivity_unit
sale	selling
s	time_unit
t	pyrimidine
stumblebum	boxer
enchantment	liking
exciting	arouse
sunset	hour
w	metallic_element
x	large_integer
information	message
regain	get
dogged	pursue
plasma	extracellular_fluid
straining	effort
spouting	pour
confluence	geographic_point
powered	provide
screenplays	script
good	advantage
empty	container
faithful	following
reproduce	produce
gong	percussion_instrument
tie	neckwear
skeleton	minimum
grizzled	sulk
curlers	mechanical_device
rendition	performance
romp	victory
suffered	experience
myriad	large_indefinite_quantity
masterpieces	work
claptrap	grandiosity
chomps	eating
irrelevancy	unconnectedness
sustains	continue
laugh	utterance
delivering	talk
fantasy	imagination
suspecting	guess
deform	change
unhappiness	feeling
disguised	hide
sand	soil
walked	travel
savaged	assail
aside	actor
cia	independent_agency
harm	ill_health
disturbed	affect
raging	act
notations	writing
provided	give
effecting	cause
rope	line
aboriginal	australian
embody	be
representation	content
sociopaths	neurotic
muster	gathering
provides	give
motivate	cause
root	plant_organ
nosedive	decline
projection	prediction
hare	leporid
assaults	battle
effectiveness	power
saps	solution
caliber	degree
plotting	plan
multiple	product
room	area
featherweight	boxer
oversimplification	simplification
better	good
creeps	animal_disease
cancer	malignant_tumor
artistes	performer
taking	action
madmen	sick_person
romance	relationship
terrifying	frighten
pupils	enrollee
illustrates	elaborate
breadth	intelligence
pile	collection
catalog	book
artistry	superior_skill
illuminates	lighten
immortal	celebrity
hats	headdress
overused	use
predisposed	dispose
pill	thing
chilly	hot_pepper
frustrations	disappointment
sexes	bodily_process
chills	coldness
burlesque	show
gained	obtain
flashing	experience
flop	computer_operation
struck	touch
hate	emotion
block	artifact
poets	writer
flow	change_of_location
order	command
conceit	pride
protecting	defend
pressed	touch
timid	people
resonance	physical_phenomenon
flog	beat
illustrated	elaborate
presses	urgency
transparency	physical_phenomenon
castrated	weaken
shockers	bad_person
tnt	explosive_compound
homage	deference
hash	dish
women	adult
scriptwriters	writer
pink	chromatic_color
woman	adult
save	prevention
cameras	photographic_equipment
scrap	fragment
ton	avoirdupois_unit
tom	black
top	region
enliven	stimulate
honesty	righteousness
concoctions	foodstuff
have	person
casting	copy
rote	memorization
redundancy	repetitiveness
shorts	trouser
jagged	cut
toy	artifact
haul	pull
adultery	extramarital_sex
implications	inference
question	questioning
drugs	agent
asian	inhabitant
spirit	vital_principle
intellectual	person
wishing	desire
goth	unpleasant_person
allegory	story
picture	representation
jugglers	performer
trusts	property
regard	detail
warmed	change
rose	shrub
markers	artifact
resurrect	resuscitate
rosa	rosid_dicot_genus
thousand	large_integer
captives	unfortunate
rooting	growth
con	argument
criticizing	comment
bedevilling	harass
kudos	approval
cop	policeman
tortured	pain
findings	collection
cow	cattle
graces	state
cox	enzyme
homicide	killing
abilities	quality
quietude	calmness
unfurls	change_surface
academic	educator
coral	pink
pipe	tube
graced	change
actress	actor
circumstances	condition
plumbs	bob
sneaks	unpleasant_person
patriot	national
introducing	inform
pardon	kindness
plenty	abundance
christmas	season
cleaver	knife
markets	activity
defeats	ending
mounting	rise
obligation	social_control
skateboards	board
spotlights	prominence
try	activity
hawk	bird_of_prey
rarity	scarcity
specialized	change
became	change_state
chicken	poultry
spliced	join
exterior	region
scenery	stage_set
scripting	write
times	time_period
mishandle	fail
cowering	crouch
muscle	contractile_organ
flux	rate
skullduggery	misrepresentation
jelly	dainty
jolted	move
says	opportunity
direction	path
comments	statement
inspector	policeman
cry	utterance
damning	raise
probe	inquiry
horizons	line
doggie	dog
activities	act
bonding	personal_relation
adopts	choose
flicks	contact
directing	order
productions	act
sketch	drawing
narcissism	conceit
respond	act
incident	happening
rorschach	projective_test
tub	vessel
caught	surprise
tug	pull
fullness	completeness
overacted	act
concert	performance
pity	sympathy
freshness	newness
infatuation	passion
fairies	spiritual_being
plaintiveness	mournfulness
infuriating	anger
defines	be
concern	interest
tux	formalwear
etched	print
state	administrative_district
strut	gait
jumble	disorderliness
worker	person
defined	be
element	part
genes	sequence
dumplings	pasta
downplays	inform
concealment	isolation
dissecting	cut
synagogue	place_of_worship
opposite	word
piss	body_waste
jackal	canine
restraint	control
aftermath	consequence
cub	novice
cue	actor
offering	message
cuteness	beauty
restrained	inhibit
directs	order
stereotype	representation
shots	propulsion
instigator	troublemaker
sweeping	cleaning
cup	container
wasting	infirmity
cut	share
warrior	person
stave	musical_notation
revelations	speech_act
weighed	measure
dread	fear
battery	artillery
two	digit
downbeat	rhythm
moment	point
shattering	breakage
halos	light
twirling	revolve
worries	negative_stimulus
tear	drop
mettle	courage
attack	operation
humour	feeling
reported	inform
skinny	information
attach	connect
shout	utterance
kitchen	room
creation	activity
inclination	attitude
stench	smell
think	deliberation
ingredient	component
participate	act
masquerading	disguise
desires	feeling
forbidden	command
wrecks	decline
accused	defendant
librarian	professional
replaced	regenerate
lottery	accident
team	unit
sleepwalk	walk
mongrel	variation
marketing	commerce
filling	material
hooting	utter
torture	distress
mistress	lover
watch	timepiece
violinist	musician
thing	situation
margins	boundary
slapped	strike
clips	supply_chamber
congeniality	compatibility
caucasian	person
registering	record
undertone	tone
elizabethans	person
sexploitation	exploitation
anna	indian_monetary_unit
participant	associate
domestic	servant
deception	falsehood
dying	end
paying	give
blows	stroke
shoot	sprout
starts	beginning
twists	development
stability	steadiness
budget	fund
glass	solid
reflection	consideration
ultimate	quality
campus	field
jacket	coat
surprising	affect
kiddies	child
privileged	permit
technologies	application
frailty	unfitness
exposing	subject
suited	meet
pacing	musical_time
opposites	word
assume	expect
thumbs	finger
clumsiness	unskillfulness
memory	representation
scientist	person
mystique	air
concept	idea
tinsel	decoration
house	building
leftovers	food
disaster	adversity
dissection	cut
underachieves	do
hitch	time_period
chilling	temperature_change
underachiever	student
lifting	move
stare	look
agnostic	person
rackets	noise
offerings	message
shoplifts	steal
hours	work_time
squashed	press
start	beginning
shore	geological_formation
stars	celestial_body
footnote	note
teen	juvenile
stylist	artist
lifestyle	manner
bypass	highway
borderline	boundary
marvel	happening
fallen	travel
hotels	building
short	tract
illuminated	lighten
replete	consume
reducing	chemical_reaction
feces	body_waste
stumbles	gait
fencing	barrier
measured	decide
rewarding	recognize
attitudes	cognition
ninety	large_integer
obstacles	hindrance
truths	fact
facade	front
hanukkah	jewish_holy_day
imagined	create_by_mental_act
squabbling	argue
consistency	property
trains	public_transport
fuddled	intoxicate
climb	slope
stylings	name
grasps	understanding
imagines	prototype
gallery	audience
flowers	angiosperm
warmth	temperature
convincing	persuade
destroy	unmake
dates	day
hostage	prisoner
deemed	see
doings	activity
coast	shore
echelons	military_unit
dolly	conveyance
dolls	plaything
shenanigans	misbehavior
ants	hymenopterous_insect
introspection	contemplation
overstated	misinform
consume	eat
planned	intend
unknown	region
cinematography	photography
comedies	drama
stereotyped	classify
competence	ability
cockney	londoner
coughed	expectorate
manners	demeanor
spellbinding	interest
wallet	case
performer	entertainer
blown	exhale
bedside	side
pipeline	gossip
downtime	time_period
ante	stake
flurries	commotion
shootings	propulsion
vignettes	description
satire	wit
hanging	decoration
cling	edible_fruit
projectile	weapon
endorsement	promotion
dad	father
friendly	military_personnel
possession	control
stoked	tend
bushels	united_states_dry_unit
shores	geological_formation
flames	combustion
frothing	bubble
runaway	victory
daughters	female_offspring
enlightening	teach
shows	entertainment
emptiness	condition
shown	show
infusion	solution
courtroom	room
storyline	plot
das	placental
interludes	time_interval
pointing	inform
speeds	rate
day	time_unit
keeps	resource
1980s	decade
living-room	room
flattened	shape
raising	rise
stereotypes	representation
drinking	consumption
island	land
format	information
shrapnel	shell
artwork	visual_communication
water	binary_compound
slasher	attacker
fried	heat
savour	taste
stays	foundation_garment
formal	dance
instructor	educator
interlocked	organize
infusing	drill
canadians	north_american
concentrating	change_state
tens	large_integer
entertain	socialize
stacked	load
savory	herb
opportunists	selfish_person
boards	theater_stage
epics	poem
comedian	performer
brimming	have
guarded	watch
tend	be
tones	manner_of_speaking
specimen	example
dated	go_out
cutes	body_covering
psychic	occultist
hinges	joint
introduction	beginning
romanticized	idealize
cynicism	pessimism
annals	journal
cursing	express
revenge	return
distill	better
built	make
therapy	medical_care
lectures	address
burdened	charge
crescendo	volume
noticing	spy
threads	clothing
concentration	property
entertained	socialize
velocity	rate
fellowship	association
diamond	jewel
third	common_fraction
confession	admission
build	bodily_property
wireless	broadcasting
further	promote
lectured	teach
methodology	epistemology
demands	request
powerhouse	actor
tolerate	permit
mixing	combination
areas	region
computerized	supply
stunning	immobilize
spews	expectorate
viewing	display
finds	insight
interdependence	reciprocality
overwritten	write
sloppiness	wetness
preaches	lecture
exuberance	enthusiasm
cube	regular_polyhedron
crisp	snack_food
prejudices	partiality
memoir	autobiography
servitude	bondage
going	act
stacks	large_indefinite_quantity
rough-hewn	hew
shock	stupefaction
impact	contact
reassures	calm
beginnings	happening
uhf	radio_frequency
skeptics	intellectual
attitude	cognition
exalts	praise
treatment	care
average	statistic
compare	likeness
bodies	natural_object
virtues	good
choosing	decide
assailants	wrongdoer
grasp	understanding
composition	placement
wednesday	weekday
hotel	building
term	word
volcano	crack
business	enterprise
transported	move
botching	fail
right	abstraction
possible	possibility
leone	sierra_leone_monetary_unit
shoes	situation
stealing	felony
stage	time_period
taught	inform
bickering	quarrel
stupefying	desensitize
returning	travel
grumble	noise
complicated	change
transporter	truck
maximum	extremum
cynic	unpleasant_person
borrow	get
repelled	push
self-discovery	discovery
desert	biome
spotlight	prominence
finch	oscine
masterpiece	work
concocted	mix
quarter	common_fraction
die	cube
hollywood	film_industry
dig	site
rigor	difficulty
upping	increase
dip	depression
believing	basic_cognitive_process
divisions	army_unit
cues	actor
fears	emotion
cliche	remark
adamant	carbon
self-knowledge	understanding
glinting	look
poignancy	sadness
depravity	immorality
fruition	condition
midst	inside
highway	road
imperfection	state
impair	damage
stray	domestic_animal
static	noise
journey	travel
puzzles	problem
test	experiment
bray	cry
enforcement	social_control
remained	be
conviction	belief
brown	chromatic_color
brat	imp
sermon	address
feast	dinner
misleading	lead
laced	twist
acceptance	attitude
embraced	include
sanctimoniousness	hypocrisy
puzzled	confuse
final	match
expiration	end
deserving	be
distract	confuse
palate	surface
croaks	utterance
embraces	clasp
overwhelmed	arouse
back	body_part
swaying	move_back_and_forth
training	activity
expectation	belief
outdoes	beat
perkiness	cheerfulness
senegalese	african
states	administrative_district
duration	time_period
sheets	expanse
disguising	hide
load	weight
hermitage	dwelling
transfixes	interest
ignore	treat
company	institution
loaf	bread
ruminations	consideration
length	dimension
advert	promotion
expands	grow
grand	large_integer
concerns	interest
schedule	plan
deterioration	decay
overwhelming	arouse
baby	child
clicks	sound
stabs	feeling
grant	aid
choppiness	storminess
showing	display
flip-flop	decision_making
lunch	meal
relic	antiquity
helping	small_indefinite_quantity
construct	idea
attempt	activity
thick	inside
rivalry	group_action
characterizes	remember
stale	make
balance	equilibrium
revealed	show
injected	administer
lock	fastener
misadventures	misfortune
pitch	sound_property
latin	italic
text	matter
fools	simpleton
kindness	good
lying	falsification
frayed	break
fallibility	undependability
framing	conceptualization
flattening	shape
ailments	disorder
being	state
filmed	record
brew	alcohol
yielded	supply
menace	danger
plethora	excess
letdown	dissatisfaction
hoping	wish
curse	profanity
warned	inform
ups	increase
doc	medical_practitioner
dog	canine
status	state
trading	commerce
spawned	cause
nobility	elite
don	gentleman
familiarity	information
curve	line
operates	direct
bags	container
embarrassed	upset
dot	disk
underlines	stroke
stamp	solid
pours	move
3-d	movie
bands	social_group
scattered	separate
abomination	person
silences	condition
government	polity
cult	religion
stream	body_of_water
brit	european
sewer	drain
brio	activeness
dwarf	small_person
crime	transgression
brim	edge
stand	support
disappointments	dissatisfaction
surround	geographical_area
respites	relief
knows	knowing
characterized	remember
dr.	scholar
contraption	device
peaked	reach
forward	basketball_player
catholics	christian
lacks	need
underrated	misjudge
cultivation	socialization
underlined	stress
dulls	change
mail	message
stinging	pain
subject	message
use	activity
trombone	brass
sadness	feeling
main	body_of_water
liked	desire
esteemed	see
strip	part
monopoly	market
weaknesses	imperfection
bilingual	linguist
lungs	respiratory_organ
grain	atom
credit	approval
maid	domestic
likes	kind
combine	harvester
waste	material
cries	utterance
approximation	calculation
motivated	cause
twenty-three	large_integer
concentrates	ore
travesty	comedy
bearing	relatedness
dry	reformer
establishment	beginning
streak	succession
numb	desensitize
labelled	designate
re-creations	creation
wallop	consequence
compass	navigational_instrument
antidote	remedy
bumper	glass
sniffle	breathing
veterans	serviceman
twirls	fold
paradigm	inflection
commended	praise
balk	area
ball	game_equipment
groupies	fan
bale	bundle
smoking	breathing
inventing	create_by_mental_act
bald	turn
transformed	change
make	kind
impetuousness	impulsiveness
categorize	reason
opposed	argue
ready-made	artifact
gamesmanship	unfairness
intensity	magnitude
stake	share
witness	perceiver
dud	failure
fortify	change
freeing	accomplishment
due	right
adaptations	writing
dug	mammary_gland
waking	consciousness
threat	danger
navigates	travel
pumpkin	squash
properties	possession
anime	copal
invention	creativity
taunt	aggravation
fastballs	pitch
boredom	dissatisfaction
inform	communicate
dearth	lack
overwhelms	arouse
stinker	unpleasant_person
crammed	stuff
hogwash	drivel
friendships	relationship
sorrow	sadness
cure	medicine
parsing	analyze
trees	woody_plant
constraints	confinement
observed	spy
rehashes	material
observer	person
hiding	activity
bank	slope
dvd	optical_disk
schmaltz	mawkishness
whining	travel
meaning	message
reassure	calm
brow	feature
bang	blow
drawing	artwork
exoticism	foreignness
palette	scope
band	social_group
orbit	path
mama	mother
interpretations	representation
10	large_integer
11	large_integer
upheaval	disorder
boxes	container
12	large_integer
devaluation	regulation
13	large_integer
15	large_integer
singing	musical_performance
august	gregorian_calendar_month
didacticism	communication
flourishes	gesture
18	large_integer
mall	walk
19	large_integer
allied	consort
benefit	payment
balm	balsam
cracking	noise
labor	class
overpowered	beat
theorizing	expect
sober	change
20	large_integer
male	animal
transporting	move
22	large_integer
25	large_integer
worlds	natural_object
26	large_integer
experiments	scientific_research
scan	examination
scam	swindle
industry	commercial_enterprise
long	desire
uproar	disturbance
ravaging	plundering
cedar	conifer
profane	change
frightening	bullying
freighter	cargo_ship
invites	invitation
relationship	relation
30	large_integer
workers	person
cuts	share
twinkle	change
bother	perturbation
expression	countenance
re-creation	creation
childhood	time_of_life
star	celestial_body
overachieving	do
self-consciousness	embarrassment
eccentricity	unfamiliarity
scarifying	puncture
checklist	list
bundling	courtship
exploiting	use
stay	act
releases	merchandise
debuts	beginning
seduces	persuade
stab	feeling
impostor	deceiver
coasting	glide
inspire	stimulate
impart	tell
switchblade	pocketknife
beginners	unskilled_person
disoriented	confuse
cuss	tormentor
40	large_integer
gadgets	device
seeks	movement
seller	merchant
devote	use
agent	causal_agent
treat	nutriment
starving	privation
woodland	biome
engendering	cause
rapid	waterway
seven	digit
expressing	convey
itinerant	laborer
affectation	pretense
3d	movie
sever	separate
bark	covering
loop	fastener
speck	spot
wood	plant_material
50	large_integer
bare	uncover
barf	body_waste
compromising	agree
bard	poet
riddles	problem
surprise	astonishment
admitted	declare
richness	abundance
sopranos	singer
murderer	criminal
seeds	fruit
sealed	close
invited	arouse
complaints	disorder
look	countenance
troubling	affect
exasperated	anger
grounds	information
achieving	succeed
mrs.	title
scar	symptom
nuts	seed
60	large_integer
eccentric	anomaly
milking	draw
knock	sound
lore	content
stooping	bend
mass	fundamental_quantity
recording	signal
speed	rate
apple	edible_fruit
inquisitiveness	curiosity
admit	declare
common	tract
interest	curiosity
riddled	pierce
adrenalin	catecholamine
bath	vessel
entertains	socialize
twin	sibling
mask	covering
masochism	sexual_pleasure
78	large_integer
winning	success
barbarian	primitive
stew	agitation
jargon	non-standard_speech
predictability	certainty
bars	gymnastic_apparatus
bart	aristocrat
strutting	walk
landing	platform
80	large_integer
separates	article
formula	mathematical_statement
step	maneuver
preteen	juvenile
rapes	mustard
disgust	dislike
mark	evaluation
tribute	approval
base	military_installation
subordinate	assistant
trend	direction
gleaned	gather
underlies	be
schlock	merchandise
thoroughfare	road
brogue	shoe
loss	transferred_property
relate	think
lost	people
90	large_integer
trifling	delay
emphasizing	action
preliminary	athletic_contest
blends	mix
van	artistic_movement
worm	invertebrate
work	activity
dizzy	change
vat	excise
mounts	horse
cattle	bovine
renting	transaction
expanse	scope
lumps	agglomeration
playoff	contest
tragedies	misfortune
tattoo	bugle_call
convince	persuade
struts	gait
irritating	displease
lingers	persist
word	language_unit
broiling	cooking
theory	explanation
love	emotion
extension	delay
gender	grammatical_category
snoots	unpleasant_person
portraying	representational_process
architect	creator
hovering	hesitate
secret	information
foundation	relation
puppies	dog
pillages	stolen_property
partnerships	business
identity	personality
ear	sense_organ
rushed	travel
eat	consume
explosions	discharge
pretends	pretense
reward	consequence
encomia	praise
graze	abrasion
converts	person
juice	foodstuff
gathering	social_group
caricatures	wit
opinion	belief
lots	large_indefinite_quantity
afghani	afghan_monetary_unit
comeuppance	consequence
flashback	transition
banzai	cheer
devotion	love
incarnation	personification
upsetting	touch
indian	amerindian
insult	disrespect
escort	defender
twinkie	sponge_cake
hospitals	medical_building
avarice	mortal_sin
seduced	persuade
formulas	mathematical_statement
existence	state
pretence	artificiality
threshold	beginning
evacuations	removal
maze	system
basketball	court_game
dimming	change_intensity
desolate	leave
subdues	oppress
ramifications	division
snooze	sleeping
chicanery	deception
hunter	skilled_worker
spell	psychological_state
exploration	expedition
slumming	spend
unsettled	upset
lows	air_mass
flim-flam	deceive
squeezed	press
revision	transformation
combustion	oxidation
thrust	force
demeanour	trait
weaves	design
seems	be
honored	recognize
weaver	craftsman
tickets	commercial_document
winter	season
clouds	physical_phenomenon
retina	membrane
walking	locomotion
animations	being
fairness	justice
martyr	victim
grave	death
advantage	asset
underscoring	stress
cloaked	disguise
cuban	west_indian
mordant	coloring_material
imparted	tell
seduce	persuade
winces	facial_expression
self-flagellation	self-punishment
demographics	statistic
exception	omission
reenactment	acting
carpets	floor_cover
hands	guardianship
mayhem	crime
year	time_period
staying	be
cruelties	maltreatment
evoking	make
hollowness	emptiness
ego	pride
ignoring	treat
anguish	distress
themes	message
banged	hit
understanding	knowing
empire	domain
absent	disappear
near	come
silence	condition
fairy	spiritual_being
victims	unfortunate
banger	pork_sausage
ragged	harass
inviting	arouse
instruct	inform
biased	prejudice
snobbery	arrogance
leaps	jump
conundrum	problem
inspired	stimulate
community	gathering
version	interpretation
percolating	trickle
refracting	subject
loony	lunatic
macaroni	dandy
stop	ending
orchard	garden
dishonesty	unrighteousness
avalanches	slide
israeli	asian
inspires	stimulate
adolescence	time_of_life
notch	indentation
convictions	belief
blarney	flattery
subculture	social_group
handguns	firearm
appropriate	assign
rhythms	musical_time
wasabi	herb
taxicab	car
least	matter
hamstrung	torment
evaporates	change_integrity
lactating	feed
swimming	water_sport
submarine	submersible
variations	change
eyeballs	capsule
inmates	resident
columbine	flower
devastated	destroy
orphans	child
themed	supply
excepting	object
representing	equal
loops	fastener
neck	external_body_part
withholds	deny
stunt	feat
characterize	remember
perceptions	representation
scooped	remove
intrusion	entrance
floundering	walk
tearing	bodily_process
leash	restraint
exploit	accomplishment
addressing	communicate
notes	written_record
generates	make
evidence	information
dancers	performer
stud	man
flamboyant	angiospermous_tree
achieves	succeed
garnish	decoration
repellent	compound
ethics	motivation
fling	attempt
suspense	apprehension
spring	season
everyman	commoner
chases	motion
generated	make
leave	time_off
shred	small_indefinite_quantity
serpent	diapsid
faint	loss_of_consciousness
bourgeois	capitalist
spouses	domestic_partner
looseness	symptom
need	condition
elm	tree
collide	conflict
staggered	walk
traditions	content
catalyst	activator
underworld	class
muckraking	exposure
crawling	locomotion
engorged	eat
lasting	measure
private	enlisted_man
boarders	tenant
companion	friend
catsup	condiment
roles	duty
sleeping	sleep
cheering	encouragement
peopled	populate
calamity	misfortune
accomplish	complete
engine	motor
end	extremity
lines	formation
bullet	projectile
packed	encase
extravaganzas	entertainment
lizard	saurian
liner	fly
scum	rabble
bathos	expressive_style
forty	large_integer
cipher	message
pageant	representation
aplomb	composure
preciousness	expensiveness
hippie	reformer
jumpsuit	garment
special	offer
forum	meeting
contempt	dislike
environment	situation
pratfalls	spill
undertaking	work
kicks	blow
achieved	succeed
progressive	tense
rappers	singer
jokes	wit
trier	judge
tries	activity
education	activity
occupation	activity
called	label
springs	season
togetherness	closeness
gangster	criminal
enthusiasts	supporter
turns	curve
apex	extreme_point
bravo	murderer
aspire	plan
tried	act
explode	change_integrity
brave	warrior
narrow	strait
proceedings	due_process
abrasive	material
idiots	simpleton
splitting	change_integrity
fleeting	travel_rapidly
shape	spatial_property
stitched	fasten
allegiance	cooperation
forte	asset
clocks	storksbill
apes	primate
brawn	strength
charming	attract
careens	lurch
singer	musician
persecuted	torment
cell	compartment
believability	quality
self-help	aid
underplays	act
inertia	trait
cribbing	cheat
vacuum	emptiness
asked	communicate
era	time_period
amish	mennonite
transplant	animal_tissue
share	assets
crucifixion	execution
television	broadcasting
dispel	move
throbbing	pulse
sharp	musical_notation
species	taxonomic_group
choreographed	make
uncluttered	change
avant-garde	artistic_movement
melts	heating
disorienting	confuse
flies	space
remade	produce
shake	building_material
navel-gazing	self-absorption
screed	harangue
spice	preservative
finery	attire
screen	surface
chops	physical_phenomenon
mexican	central_american
dwellers	person
trial	attempt
perception	representation
exploitation	use
updating	change
visualize	imagine
tucked	enclose
secretions	organic_process
wimps	weakling
turks	turki
tropes	rhetorical_device
subjected	affect
substitutes	equivalent
woods	vegetation
articulate	supply
one-liners	joke
brass	copper-base_alloy
regalia	gear
breasts	external_body_part
driving	golf_stroke
careers	occupation
traverse	beam
followers	multitude
races	contest
secular	commoner
companionship	friendship
activate	initiate
bungling	fail
strays	domestic_animal
amusement	delight
infatuated	arouse
shame	feeling
malarkey	talk
spied	spy
skateboard	board
angles	space
condescension	arrogance
overdone	make
elderly	age_group
ferocity	intensity
straddles	position
progression	series
dreams	imagination
ensemble	musical_organization
brats	imp
trick	device
light-years	astronomy_unit
pollute	dirty
running	football_play
mugging	assault
righteousness	morality
spies	secret_agent
credits	acknowledgment
boils	staphylococcal_infection
flick	contact
render	stucco
declared	state
endeavor	undertaking
rates	tax
requirement	duty
rolls	rotation
pencil	writing_implement
plots	scheme
rated	evaluate
chord	straight_line
chore	duty
appetite	craving
transpose	matrix
strategy	plan_of_action
forms	word
hiatus	interruption
victories	ending
achievements	action
belgian	european
establishing	open
couch	seat
sequins	adornment
seesawed	play
skills	ability
represented	equal
attractions	force
remorse	sorrow
chemicals	material
shoots	sprout
phonograph	machine
waves	movement
dreaminess	easiness
adolescents	juvenile
remain	be
expected	evaluate
voices	sound
sustenance	food
eye	sense_organ
argues	present
sizzle	noise
envelope	container
glaring	stare
liberating	change_state
barbs	remark
mixer	party
mixes	concoction
envelops	cover
shines	brightness
continent	landmass
feels	awareness
tongue-tied	deprive
disturbance	activity
beguiling	cheat
guarantee	assurance
improvise	perform
enemy	military_unit
stammering	talk
journalists	writer
hindered	prevent
comeback	reply
shiner	bruise
knack	endowment
gray	achromatic_color
tropic	latitude
anguished	suffer
enthusiasms	feeling
diction	articulation
structured	organize
ingredients	component
backbone	support
magician	performer
outtakes	scene
triumph	ending
discovering	spy
horror	fear
newcomers	novice
black	achromatic_color
liberation	accomplishment
sensitivities	sense
showers	plumbing_fixture
recovered	get
classic	creation
splashing	painting
describe	set_forth
suck	consumption
grab	mechanical_device
grad	angular_unit
countenance	appearance
battered	strike
pulchritude	beauty
administration	management
internalized	impute
sterling	money
developing	processing
remains	object
dwell	worry
incorporate	compound
cocoon	natural_object
refreshes	remember
features	property
wallowing	indulge
white	person
counterpart	equivalent
menacing	exist
shimmers	change
seeming	be
commercialism	transaction
might	strength
duplicate	artifact
sharing	mutuality
expressions	countenance
unbridled	get_rid_of
limps	gait
servants	worker
wonders	astonishment
museum	depository
trumpet	brass
leads	advantage
solemnity	seriousness
installment	payment
orbits	path
clothing	consumer_goods
jostles	shove
import	commodity
classes	collection
lowbrow	plebeian
snatch	fragment
conclusion	judgment
central	workplace
daunting	intimidate
trademark	characteristic
heralds	messenger
backyard	yard
cashing	exchange
supporting	activity
memorial	recognition
factor	cause
undoing	about-face
derived	reason
news	information
greek	indo-european
frissons	fear
griffin	mythical_monster
green	chromatic_color
clotted	change_state
refreshed	remember
race	contest
wan	computer_network
war	military_action
remake	creation
derives	reason
grew	change
realization	understanding
way	property
bothered	strive
clear-cut	clear
sensation	perception
summons	invitation
african	person
angelique	herb
window	framework
attempted	act
play	dramatic_composition
disciplined	develop
fad	fashion
pleaser	entertainer
insurrection	conflict
issues	content
fan	device
posturing	conceit
oomph	attractiveness
stuck	fasten
prostitute	woman
titans	important_person
fat	lipid
greed	desire
baffled	people
fax	duplicator
plan	idea
reassembled	assemble
double	base_hit
suicide	killing
bewildered	confuse
rendering	performance
naturalness	quality
suit	garment
chocolate	beverage
denial	speech_act
study	examination
widget	stuff
differences	quality
irish	nation
second-guess	predict
melds	rummy
gain	indefinite_quantity
engross	concentrate
supermarket	grocery_store
leaks	hole
receiving	get
web	object
memories	representation
feeds	food
physician	medical_practitioner
stardom	high_status
relieved	better
honeys	sweetening
grin	facial_expression
conduits	passage
wen	cyst
castles	mansion
grip	grasping
explore	investigate
befuddled	be
grit	sandstone
wet	wetness
climate	environmental_condition
eyelids	protective_fold
aisles	passage
great	achiever
staggering	walk
wanton	sensualist
discoveries	act
gags	wit
pleased	satisfy
rage	anger
behold	see
sides	region
unburdened	take
organizing	make
stuff	substance
wondered	question
dick	detective
booking	employment
donna	woman
monkey	primate
heist	robbery
distinction	discrimination
arrest	capture
intelligentsia	elite
section	music
discontent	longing
rumor	gossip
looks	countenance
psychedelia	subculture
provoke	make
presented	show
few	elite
highways	road
snacks	meal
plods	walk
strain	deformation
rain	precipitation
laugher	person
rail	barrier
laughed	express_emotion
victimized	wrong
sunk	change_posture
winded	travel
plea	entreaty
sung	dynasty
exceptions	omission
produced	make
voyage	water_travel
viewers	audience
sledgehammer	hammer
chokes	coil
gait	rate
revisited	return
outside	region
effect	phenomenon
misogynist	misanthrope
explaining	inform
produces	food
producer	maker
topic	message
hunk	man
inhale	smoke
sugar	sweetening
who	united_nations_agency
option	derivative_instrument
politics	social_relation
popping	sound
game	activity
revisiting	return
pathology	medical_science
unveil	uncover
contribute	change
why	reason
faith	belief
letterman	athlete
founders	inflammation
died	change_state
microscope	magnifier
integrated	compound
candidate	politician
damned	people
wig	hairpiece
peanut	pod
dies	cube
win	victory
fluids	substance
soccer	football
butter	dairy_product
wit	message
fondness	liking
crackles	noise
cannibal	savage
electric	car
gall	animal_disease
geared	adapt
recommended	propose
fizzle	noise
barriers	obstruction
matters	concern
theaters	building
posterity	biological_group
stanzas	text
blockbusters	general-purpose_bomb
attention	basic_cognitive_process
visit	meeting
denied	contradict
rake	libertine
hip-hop	youth_culture
integrates	compound
extent	degree
escapade	undertaking
rant	declamation
parent	genitor
fillers	sealing_material
intermediary	negotiator
fit	bad_temper
skins	body_covering
hush	silence
fix	difficulty
excites	arouse
rank	line
assumption	postulate
outlet	place_of_business
digs	excavation
deaths	change
addition	component
surf	wave
doubts	cognitive_state
barrow	containerful
embellished	overstate
buckaroo	cowboy
foibles	peculiarity
gang	association
ad	promotion
grow	change
excited	arouse
ai	agency
am	metallic_element
an	associate_degree
former	first
panic	fear
blowing	processing
muting	soften
as	chemical_element
at	chemical_element
haunted	pursue
interpretation	representation
dullness	stupidity
folk	people
looking	sensing
formed	make
hurt	ill_health
screwball	eccentric
hideousness	ugliness
reeked	suggest
ba	metallic_element
slugfest	fight
be	metallic_element
prove	be
bloodletting	medical_care
cherished	love
admire	respect
looney	lunatic
institutionalized	transfer
intimacy	friendliness
rape	mustard
notions	idea
fool	simpleton
experimentation	inquiry
popularity	quality
genre	kind
trickery	misrepresentation
ca	metallic_element
develops	create
tooth	bone
foot	vertebrate_foot
wills	faculty
enabling	change
cd	metallic_element
scoring	evaluation
charge	attack
keeping	conformity
familiar	servant
co	monoxide
regimented	control
gaps	disparity
food	substance
fly	dipterous_insect
partner	domestic_partner
scrawled	write
plunge	swimming
interview	interrogation
da	prosecutor
byzantine	asian
adobo	dish
tearjerker	narrative
scarf	garment
accomplishes	complete
scare	anxiety
gasp	inhalation
grub	fare
language	communication
do	party
woe	misery
fore	front
observe	spy
whooshing	move
strangeness	unusualness
payoffs	payment
protagonists	advocate
accomplished	complete
attacks	operation
equalizer	electronic_equipment
showtime	point
won	south_korean_monetary_unit
strictness	conscientiousness
criticism	disapproval
creativity	ability
needy	poor_people
wow	joke
liman	lagoon
ed	dysfunction
excruciating	pain
needs	condition
caricature	wit
coinage	currency
el	angular_position
em	area_unit
favored	promote
blight	devastation
goodies	nutriment
er	metallic_element
babbitt	alloy
phantom	spirit
usurp	take
piece	part
screams	cry
aspiration	ambition
vexing	displease
elephant	pachyderm
paycheck	check
jumbled	be
limbs	extremity
mortarboards	board
tears	bodily_process
whiff	gust
argentinian	south_american
loneliness	isolation
watching	look
twilight	hour
content	collection
enticing	provoke
attuned	adjust
plot	scheme
rate	magnitude_relation
alert	readiness
skill	ability
knockabout	sloop
rats	rodent
contend	claim
covers	covering
vistas	visual_percept
plod	walk
fuses	electrical_device
go	shift
atmospherics	noise
plastered	cover
syrup	sweetening
humanizing	change
rhythm	musical_time
chewing	change_of_state
tease	unwelcome_person
skims	covering
rash	eruption
fork	cutlery
dime	coin
blandness	unemotionality
form	word
quickie	repair
fused	change_integrity
self-expression	expressive_style
earplugs	earphone
ha	angular_distance
sedate	affect
wrestling	struggle
co-stars	star
he	chemical_element
orchestrated	score
limbo	obscurity
hi	greeting
placed	move
ho	metallic_element
welfare	aid
hyphenate	spell
flourish	gesture
foul	violation
relationships	relation
appeared	be
four	digit
context	discourse
collaborators	accessory
manipulation	influence
bathroom	room
ii	digit
plates	base
in	linear_unit
maturity	time_of_life
civics	social_science
dismissed	reject
iq	ratio
robustness	strength
audacity	boldness
it	engineering
schemes	plan_of_action
aimed	position
hustlers	prostitute
somebody	causal_agent
sadism	sexual_pleasure
lapses	mistake
talked	communicate
understated	inform
distraction	confusion
avengers	attacker
delusions	psychological_state
contrast	opposition
50s	large_integer
brittle	candy
annoying	mistreatment
become	change_state
affinity	attraction
recovering	get
gays	person
bottom-feeder	scavenger
eagerness	enthusiasm
fearlessness	feeling
subscription	payment
zips	relative_quantity
sparkling	change
whirl	movement
literature	writing
innuendoes	implication
sending	causing
ability	quality
belief	content
abyss	chasm
delight	pleasure
continuum	time
suggestion	idea
dips	depression
overrides	device
distracting	confuse
lantern	lamp
places	point
disposition	nature
la	metallic_element
otherness	difference
equals	person
le	autoimmune_disease
misunderstood	interpret
bailiwick	jurisdiction
trinity	digit
li	metallic_element
fun	diversion
accomplishment	action
crooned	sing
hicks	rustic
pants	underpants
purports	meaning
dreck	merchandise
while	time
photos	representation
overexposed	expose
swagger	itinerant
second	time_unit
suggests	declare
bypassing	avoid
picked	choose
documented	record
crooning	singing
limit	extent
communication	act
tolerance	endurance
contest	social_event
tinge	small_indefinite_quantity
alabama	south
turmoil	disturbance
niches	place
author	communicator
misfit	anomaly
possessed	have
feeling	state
charms	attractiveness
rekindle	kindle
plus	quality
expansion	increase
appetites	craving
entry	written_record
fuddy-duddy	conservative
license	legal_document
na	metallic_element
dream	imagination
dish	container
gaze	stare
possesses	police
noble	male_aristocrat
essay	writing
plug	blockage
warped	misrepresent
totalitarian	disciple
heat	energy
no	negative
treads	step
formalism	doctrine
houseboat	barge
legacy	gift
student	enrollee
terrorists	radical
ideology	orientation
seal	fastener
mixed	change_integrity
illusion	appearance
head	external_body_part
dialog	talk
whine	complaint
misunderstanding	interpretation
prozac	selective-serotonin_reuptake_inhibitor
heal	better
dive	cabaret
heap	collection
hear	perceive
rescue	recovery
occupied	work
avenues	approach
diva	opera_star
pushiness	assertiveness
slights	discourtesy
sports	diversion
os	orifice
flabbergasting	surprise
tendencies	attitude
families	unit
cousin	relative
newness	age
pa	father
pb	metallic_element
pc	digital_computer
perspectives	orientation
manipulating	influence
ricochets	recoil
communicating	act
sitting	motion
subversive	radical
nation	political_unit
rocket	vehicle
adaptation	writing
downfall	failure
determination	discovery
convenience	comfort
discipline	knowledge_domain
profanity	utterance
revulsion	disgust
morgen	area_unit
scarlet	red
fistfights	fight
pornography	creation
tongues	articulator
ripping	tear
hundreds	large_integer
expiry	end
blending	combination
brand	name
suspension	mixture
choke	coil
inevitable	destiny
veered	turn
insanity	mental_illness
consciousness	cognitive_state
bagatelle	musical_composition
frustration	disappointment
skyscraper	building
then	point
lagging	insulating_material
tightened	change
seat	space
veggie	produce
seas	body_of_water
re	metallic_element
bow-wow	bark
concepts	idea
adopt	choose
wander	travel
pastiche	musical_composition
fetishism	belief
bridge	structure
singular	form
commentary	statement
parodied	act
homosexuality	sexual_activity
belly	body_part
serenity	composure
discovered	spy
distracts	confuse
confection	dainty
crawls	motion
executed	kill
seek	movement
seen	perceive
sa	militia
seem	be
pileup	collision
compelled	induce
si	chemical_element
origins	point
grandstanding	perform
lecture	address
so	solfa_syllable
teenager	juvenile
intern	doctor
necessary	thing
starter	electric_motor
dampened	suppress
decision	choice
souls	spirit
closet	storage_space
chomp	eating
heed	attention
closes	end
monster	imaginary_being
closer	person
flower	angiosperm
dismantle	destroy
single	base_hit
compressed	wedge
fingered	touch
joins	connection
tv	broadcasting
commercial	ad
joint	body_part
separate	article
generations	people
endangered	exist
rules	concept
wheezing	breathe
biting	grip
loaded	fill
insignificance	unimportance
ambiguity	saying
capturing	represent
embracing	clasp
un	world_organization
military	force
up	increase
ut	time
alacrity	liveliness
tweaked	pinch
anarchy	disorder
carnage	murder
thin	change_state
cartoons	wit
sees	seat
failure	nonaccomplishment
a-list	list
know	knowing
bolster	pillow
heft	heaviness
suggesting	declare
preview	ad
sorority	club
populace	people
streamlined	contour
breakthrough	insight
imprint	influence
changes	happening
gag	wit
frustrating	prevent
swirling	revolve
filming	photography
cringe	move
examination	investigation
grownups	person
gap	disparity
gas	state_of_matter
creations	activity
slopped	move
overweight	fleshiness
gay	person
shriek	cry
veiling	net
slight	discourtesy
reading	linguistic_process
argue	present
directive	pronouncement
pedigree	genealogy
enactments	legislation
self-indulgence	indiscipline
veers	turn
talents	natural_ability
footnotes	note
bankrupt	failure
kidnapping	capture
exhibitionism	ostentation
courts	assembly
dragon	mythical_monster
type	kind
hell	region
april	gregorian_calendar_month
helm	steering_system
odyssey	journey
yi	loloish
meddles	intervene
scant	work
terms	status
proof	evidence
sympathizing	feel
surrounding	touch
quashed	oppress
encompasses	include
teams	unit
atrocities	inhumaneness
nails	horny_structure
contract	written_agreement
veracity	truthfulness
misfortune	trouble
iconography	picture
befuddling	be
insight	perception
readings	linguistic_process
revolutionary	radical
scrooge	hoarder
fabric	artifact
argot	non-standard_speech
exact	claim
unemployment	state
praying	commune
force	influence
splendor	brightness
confounded	be
surrounded	touch
gasps	inhalation
barbed	change
tools	implement
gem	art
gel	colloid
thrusts	force
hems	edge
sabotage	destruction
get	return
continues	act
resembling	match
course	education
sewing	handicraft
power	quality
semi	match
crooks	principal
nagging	complain
snaps	touch
vengefulness	malevolence
sell	sale
pickup	truck
sally	remark
naturalism	philosophical_doctrine
suspect	person
brain	neural_structure
transformation	change
thou	large_integer
sprinkled	discharge
help	activity
idling	inactivity
forcing	compel
depth	extent
endgame	end
self	consciousness
long-suffering	endurance
gasping	blow
exposition	interpretation
reminders	message
dress	woman
snail	gastropod
addresses	code
confounding	be
werewolf	mythical_monster
onion	bulb
sound	sound_property
harbor	port
translate	repeat
sales	income
impetus	force
healing	bodily_process
indignation	anger
gosling	goose
revitalize	better
strives	try
criminal	principal
creatures	organism
sensibilities	consciousness
stranded	abandon
enamored	attract
sent	estonian_monetary_unit
nightmare	situation
startle	reflex
porthole	window
purposes	goal
techniques	method
anatomical	saying
treasured	see
dissing	hurt
send	move
here	location
concrete	building_material
purpose	goal
challenges	situation
rejected	evaluate
regret	sadness
salvaged	rescue
snake	diapsid
scale	standard
thinkers	intellectual
hero	leader
candles	lamp
engaging	act
challenged	contest
omnibus	anthology
buck	horse
organize	make
salient	projection
observations	measurement
station	facility
iceberg	floater
disappointing	thwart
prose	writing_style
diverting	turn
shrill	shout
costs	reimbursement
factory	plant
smoke	aerosol
edges	boundary
follow	travel
intent	goal
factors	cause
contrasting	distinguish
plodding	labor
treats	nutriment
verges	boundary
daddy	father
conned	cheat
humdrum	unvariedness
skies	atmosphere
edged	advance
ounce	apothecaries
blighter	tormentor
celibacy	condition
platter	flatware
illustrating	elaborate
german	european
introduces	inform
teeming	hum
undergoing	change
recognized	accept
resemble	match
youth	juvenile
virgin	innocent
recruiting	register
assassins	murderer
captors	person
audience	gathering
reverie	dream
muck	matter
thus	gum
possess	police
silliness	folly
phantasms	spirit
devise	will
innovations	creation
thud	sound
recognizes	accept
bubbles	globule
much	large_indefinite_quantity
chapter	section
tadpole	larva
entitled	empower
poise	unit_of_viscosity
sights	optical_instrument
omits	extinguish
misery	ill-being
tosses	throw
alienating	change
miscalculation	mistake
maelstrom	current
boosted	raise
lights	actinic_radiation
resolved	end
committed	act
sets	collection
bumps	injury
revisionism	bolshevism
give-and-take	speech
revisionist	communist
freshman	lowerclassman
veins	blood_vessel
adage	saying
arch	curve
returned	travel
wrap	cloak
buff	follower
novel	fiction
posing	motion
a-team	team
prominence	standing
standard	system_of_measurement
reports	document
badness	quality
illuminating	lighten
correct	change_by_reversal
goo	matter
reader	scholar
grosses	large_integer
institution	organization
quandaries	difficulty
injustices	wrongdoing
ambition	desire
delinquent	wrongdoer
aspirations	ambition
avert	prevent
contributed	change
singers	musician
area	region
murder	homicide
manifestation	appearance
posits	proposition
reworking	work
european	inhabitant
mugs	containerful
hews	carve
fuels	substance
alienation	dislike
moisture	wetness
contributes	change
lack	need
bouncing	recoil
toast	bread
success	happening
ingenuity	creativity
authority	control
simmering	cooking
shocking	surprise
batting	attempt
exhilarating	elate
illogic	quality
young	animal
jangle	sound
leafing	growth
decomposition	vector_algebra
fetching	transmit
self-absorption	preoccupation
steaming	travel
eloquence	expressive_style
fluidity	thinness
paintings	graphic_art
infiltrated	percolate
standardized	regulate
lodging	structure
illumination	condition
xtc	methylenedioxymethamphetamine
evolution	process
portrait	word_picture
clamoring	cry
adoring	love
namesake	person
acidity	taste_property
redemption	rescue
complaint	disorder
pinnacle	steeple
battlefield	tract
lady	woman
ethos	attribute
magazine	press
slimed	dirty
inject	administer
amassed	increase
debating	consider
remakes	creation
t-shirt	shirt
pocket	pouch
suffocating	kill
named	label
neglects	inattention
injustice	wrongdoing
indifference	unconcern
considered	think
channel	transmission
enervating	weaken
focus	concentration
cutter	quarryman
delivered	talk
groaner	person
entire	male_horse
approach	conceptualization
flashes	happening
homophobia	bias
doting	senesce
exaggeration	trope
lags	delay
borrows	get
palestinian	arab
tremors	vibration
thesis	premise
bump	injury
cameo	anaglyph
write	create_verbally
curling	game
dripping	flow
musical	movie
suffocation	killing
loyalty	fidelity
dismiss	reject
classroom	room
picnic	vacation
underlying	be
verisimilitude	semblance
heaven	region
upbeat	prosperity
suspended	hang
intelligence	ability
winner	contestant
reclaiming	get
million	large_integer
captivating	attract
ambience	condition
arrogance	pride
erotic	sensualist
shadows	shade
bulk	number
appearing	attendance
despair	condition
bull	cattle
champion	rival
gum	sweet
gun	weapon
balding	turn
wait	pause
hundred	large_integer
circuit	electrical_device
queen	insect
artefact	whole
gut	internal_organ
guy	man
potshots	shooting
chords	straight_line
dysfunction	pathology
waif	child
buoy	reference_point
native	person
smothered	cover
wail	complaint
misconceived	interpret
documentary	movie
tempted	invite
cutoffs	limit
laid	move
consequence	phenomenon
gothic	east_germanic
dominant	note
heading	line
discussed	cover
worrying	harassment
opportunities	possibility
lampoon	caricature
jammies	nightwear
jaded	devolve
lingering	delay
framework	hypothesis
names	defamation
artworks	visual_communication
messenger	traveler
xxx	large_integer
slathered	spread
chronicle	record
possibilities	expectation
tonight	present
predecessors	precursor
franchise	concession
tabloid	journalism
classicism	artistic_style
amnesiac	handicapped_person
supernatural	causal_agent
sustained	continue
suits	garment
associate	peer
detract	reduce
wake	consequence
tics	twitch
whipping	beating
compendium	publication
sneak	unpleasant_person
counting	investigation
executives	administrator
void	nonexistence
ritual	custom
dispense	give
liability	susceptibility
swan	aquatic_bird
sway	power
tick	sound
basis	foundation
affected	change
pleasures	feeling
complexities	quality
arms	instrumentality
basic	programming_language
twist	development
lake	body_of_water
flounders	flatfish
dislocation	interruption
raptures	emotional_state
nuance	meaning
sneers	contempt
bush	woody_plant
bearded	rim
in-joke	joke
muse	greek_deity
combat	battle
units	definite_quantity
restoring	regenerate
mush	mass
drooling	covet
sacrificed	release
unity	state
murk	atmosphere
choreography	dancing
eviction	compulsion
pursue	act
tier	rank
ties	neckwear
busy	work
convey	impart
extra	actor
u-boat	submersible
land	real_property
bust	failure
lane	way
sacrifices	act
burn	pain
sleaziness	dishonorableness
tied	fasten
performing	activity
sandbox	mold
outbursts	expression
automatic	automatic_firearm
encyclopedia	reference_book
conduct	activity
melodramas	comedy
salvos	outburst
burr	pericarp
wall	partition
walk	locomotion
lame	simpleton
stinks	smell
marred	damage
refusing	react
culled	get_rid_of
riled	displease
botches	mistake
offbeat	rhythm
marry	unite
dimwits	simpleton
decay	natural_process
styled	name
discussion	communication
irrigates	wet
crowds	gathering
unleashed	let_go_of
imbued	penetrate
bates	control
lessen	change_magnitude
botched	fail
championship	high_status
camaraderie	sociability
thinks	deliberation
arrangements	planning
welcome	acceptance
unleashes	let_go_of
events	psychological_feature
chaos	confusion
mankind	group
edited	change
earns	get
want	poverty
geniality	friendliness
uncover	show
induce	generate
wane	decline
difference	quality
baffle	plate
must	necessity
styles	property
circle	ellipse
butt	stock
estranged	take_out
sophisticated	educate
discarded	get_rid_of
reside	populate
ward	person
hitting	touch
chase	motion
raving	declamation
colors	flag
accident	mishap
sophisticates	adult
found	wage
aficionados	sports_fan
defense	military_action
chasm	opening
hispanic	american
knight	male_aristocrat
lark	new_world_oriole
arts	discipline
limits	extent
cruelty	maltreatment
beating	fight
fanatics	enthusiast
affability	friendliness
refresh	remember
intimate	friend
combining	union
religion	belief
tragedy	misfortune
charm	attractiveness
ghosts	apparition
contrived	create_by_mental_act
mulls	promontory
evoke	make
crudity	wild
till	soil
antagonism	state
waged	contend
shovel	hand_tool
voting	choice
goods	advantage
forsaken	leave
screenplay	script
lynch	kill
jolts	blow
wasp	protestant
school	educational_institution
ham	cut_of_pork
things	property
hat	headdress
passages	change_of_state
has	angular_distance
sameness	quality
residences	address
brush	vegetation
unlock	open
last	end
happenstance	accident
trapped	confine
waxes	lipid
weighs	measure
groaners	person
wash	water-base_paint
batch	collection
weight	physical_property
preserves	confiture
warn	inform
warm	change
measure	maneuver
transcendence	being
chalk	calcite
wars	military_action
updated	modify
swim	water_sport
prank	folly
physique	bodily_property
commune	administrative_district
impossible	impossibility
effort	activity
mends	sewing
bullock	bull
bolero	dance_music
showdown	disagreement
harshness	roughness
video	visual_communication
updates	news
vegetables	produce
wave	movement
yesterday	day
sugarcoated	sweeten
cocktail	mixed_drink
genres	kind
ends	extremity
denying	contradict
characterisations	description
steady	lover
vote	choice
disrespected	relate
disease	illness
yes	affirmative
loathe	hate
raccoons	fur
disposable	item
colour	material
alternating	change
clarity	comprehensibility
disobedience	insubordination
pop-up	book
time	case
highs	degree
horrifying	frighten
buzz	sound
sniping	hunt
analgesic	medicine
governments	polity
stoops	inclination
hem	edge
zoning	division
grandness	standing
circus	company
granddad	grandparent
odour	sensation
desiccated	preserve
molested	assail
torpedo	murderer
okay	sanction
aggravating	change
russian	native
lesson	teaching
thumbing	ride
nonfiction	prose
philosophy	belief
slope	geological_formation
dawdle	move
doubles	badminton
chiaroscuro	picture
niche	place
diatribes	denunciation
worship	activity
lawn	field
flinging	throw
emphasizes	express
scooping	remove
tourism	commercial_enterprise
merits	worth
smart	pain
triangle	polygon
layer	artifact
alien	traveler
nicks	blemish
beaches	geological_formation
tomatoes	solanaceous_vegetable
ways	structure
bullfighters	person
emphasized	express
confusing	mistake
smash	blow
ledger	record
rigors	difficulty
editor	skilled_worker
grasping	understanding
chain	series
chair	seat
quirkiness	unfamiliarity
randomness	physical_property
reverse	opposition
sword	weapon
deleting	remove
garden	plot
immersed	penetrate
lays	song
small	body_part
tits	mammary_gland
rhino	odd-toed_ungulate
fiction	literary_composition
shallows	body_of_water
hip	body_part
bruin	bear
temptations	influence
hit	feat
playwright	writer
schmucks	jerk
suavity	graciousness
emphasis	importance
beat	path
bear	carnivore
grandfather	grandparent
potential	possibility
bean	legume
psyche	cognition
tapping	sound
bruised	injure
lounge	seat
resist	elude
shouting	encouragement
history	past
searing	heat
stimulate	affect
square	rectangle
camps	military_quarters
vectors	variable
interference	foreign_policy
muddled	roil
psycho	sick_person
anarchist	radical
misconstrued	interpret
beck	gesture
devolves	delegate
values	belief
reveals	show
steals	purchase
mushes	mass
point	component
debut	beginning
polished	fancify
neurotics	sick_person
robberies	larceny
sounds	sound_property
attachment	affection
slivers	bit
alias	name
portuguese	romance
hospital	medical_building
dimension	magnitude
wildlife	life
chen	bird_genus
deserve	be
exude	excrete
restore	regenerate
inventiveness	creativity
fugitive	person
alternative	decision_making
crowded	move
hankies	piece_of_cloth
meal	nutriment
debts	indebtedness
gushing	pour
throwaway	street_urchin
mean	average
meat	food
re-create	make
chew	morsel
nominated	nominate
pedestrian	traveler
ferret	musteline_mammal
romeo	lover
numbing	desensitize
jumps	increase
advance	change_of_location
appreciate	acknowledge
mothers	parent
homogenized	equal
denouements	result
killer	person
reflects	indicate
beer	brew
bees	hymenopterous_insect
limitations	rule
delighted	satisfy
opportunity	possibility
court	assembly
distort	misrepresent
bestowing	award
misuse	use
trimmings	accessory
deals	transaction
dealt	broach
lumbering	trade
natives	person
corpse	body
lured	provoke
organ	body_part
begs	plead
depict	represent
perennial	plant
shiver	reflex
hop	jump
vanity	pride
hos	metallic_element
characteristic	property
libido	sexual_desire
interior	region
opportunism	selfishness
epicenter	geographic_point
assembly	machine
handiwork	work
bully	attacker
lurches	gait
testosterone	androgen
chin	feature
whimsicality	irresponsibility
endeavors	undertaking
subjects	message
vietnamese	asian
dragged	pull
hibernation	torpor
march	gregorian_calendar_month
blast	fly
rehearsals	exercise
popped	change_shape
advantages	asset
answer	statement
meet	athletic_contest
calls	telephone
underscore	stroke
boilerplate	formulation
paeans	praise
restored	regenerate
wizard	expert
aging	organic_process
misplaced	put
passions	feeling
abused	treat
celebrity	important_person
negated	deviate
spangle	adornment
putting	golf_stroke
questions	questioning
corpus	capital
promise	commitment
playboy	hedonist
overstating	misinform
pinheads	simpleton
waffle	cake
antics	diversion
leaner	throw
undernourished	feed
ignored	treat
zeroes	relative_quantity
perpetrated	act
afterthought	reversal
count	number
hrs	time_unit
failings	imperfection
gobble	cry
outlandishness	unfamiliarity
vision	imagination
rawness	damp
ripening	organic_process
blame	accusation
70s	large_integer
cadences	poetic_rhythm
confusion	disorder
personalities	attribute
carrying	move
auditorium	area
blank	character
stein	mug
operas	classical_music
waiting	inactivity
beginning	happening
evocation	imagination
skewering	pin
partisans	advocate
exposes	exposure
exposed	subject
bloody	cover
notice	announcement
preordained	predetermine
rambling	continue
transfigures	change
mythologizing	fabricate
rumblings	noise
michael	archangel
tomfoolery	play
spectacular	performance
hue	color_property
decades	time_period
winks	moment
diplomat	official
hug	embrace
bedtime	hour
sleaze	tastelessness
president	corporate_executive
benjamins	gum_resin
ransom	cost
lector	clergyman
reaches	limit
simulation	model
shivers	reflex
dropped	move
artifice	maneuver
tracking	pursuit
glued	attach
kitten	young_mammal
melt	heating
religions	belief
action	act
lurks	hide
nonconformist	protestant
electrocute	kill
gauge	measuring_instrument
soundtrack	sound_recording
energizing	activity
chou	dynasty
belt	loop
suspected	guess
chop	physical_phenomenon
undercut	material
sensitive	psychic
blockage	physical_condition
fantasia	musical_composition
fires	happening
afford	spend
dustbin	bin
explored	investigate
asks	communicate
impression	idea
sieve	strainer
nonconformity	disagreement
acting	activity
careening	walk
floppy	magnetic_disk
explores	investigate
stymied	prevent
granger	creator
deliver	talk
recapitulation	growth
headed	proceed
phenomenon	process
obsession	irrational_motive
kibosh	prevent
eight	digit
products	commodity
broadside	ad
trailer	idler
pained	hurt
sensibility	consciousness
boomer	person
degenerates	reprobate
grandiosity	expressive_style
expressiveness	quality
dullard	simpleton
travail	parturition
illness	ill_health
topics	message
strike	job_action
bent	inclination
smack	blow
gaudy	banquet
menu	bill
culmination	phase
radar	measuring_instrument
interviewees	respondent
trusted	believe
incinerates	burn_down
teddy	plaything
misfiring	fail
workplace	geographic_point
leavened	raise
codes	written_communication
forged	beat
cheapen	worsen
conscience	ethical_motive
shootouts	fight
banquet	dinner
british	nation
thrill	exhilaration
blade	leaf
radio	broadcasting
irreverence	attitude
solution	mixture
berg	floater
mourns	grieve
international	socialism
calculated	reason
jolly	party
citizen	national
cities	municipality
accepts	evaluate
crackle	noise
sooner	american
steps	stairway
dentist	medical_practitioner
friends	person
eroded	decay
professor	academician
dubbed	name
meow	cry
forges	furnace
troupe	organization
strengths	property
principles	generalization
present	time
weber	flux_unit
curtain	blind
problems	difficulty
belong	be
transgression	wrongdoing
borders	boundary
rat-a-tat	tapping
surveys	examination
best	attempt
movements	change
mess	disorderliness
frat	club
allusions	mention
narcotized	drug
transform	change
ayatollah	religious_leader
attracting	pull
rooted	grow
steamboat	boat
shocker	bad_person
probing	investigate
immune	person
churns	vessel
pretended	misrepresent
snuck	walk
stern	rear
shocked	surprise
master	artist
attraction	force
traffics	collection
crapulence	intemperance
puzzle	problem
hypocrisy	pretense
mere	pond
drawling	pronounce
gremlins	fairy
ballerinas	ballet_dancer
splatter	noise
impacting	wedge
originality	ability
trims	neatness
moralizing	philosophizing
blockbuster	general-purpose_bomb
vices	evil
theatre	building
cover	covering
reflect	indicate
restatement	statement
massacre	murder
outpaces	surpass
edits	change
lobotomy	psychosurgery
bungle	mistake
runner	criminal
obsessive	neurotic
adventures	undertaking
temporal	semantic_role
hawaiian	oceanic
backdrop	scenery
underdog	failure
zap	event
whippersnappers	cipher
intention	goal
pointed	inform
rudd	cyprinid
impulse	motivation
crystallize	shape
profundities	wisdom
religious	religious_person
shower	plumbing_fixture
saturday	weekday
fact	information
contradicts	deviate
grandparents	forebear
reacting	act
melting	heating
fret	agitation
reshaping	determine
self-determination	autonomy
oddballs	anomaly
pieces	part
swooping	descend
monotony	unvariedness
fade	golf_stroke
conniving	assent
mermaid	imaginary_being
christian	religious_person
free	people
schoolgirl	female_child
rebellion	resistance
reaction	chemical_process
babes	child
faked	re-create
wavers	communicator
bothers	perturbation
weary	indispose
wears	deterioration
propelled	move
knitting	needlework
monotone	intonation
raindrop	drop
evolve	create_by_mental_act
face	external_body_part
stagnation	inaction
tripe	variety_meat
household	unit
invite	invitation
coordinated	arrange
ratio	magnitude_relation
refugees	exile
instinct	aptitude
ice	crystal
shrug	gesture
hairline	line
independence	freedom
honors	symbol
melancholy	sadness
spike	electrical_discharge
presentation	ceremony
glimmer	flash
ruin	devastation
commands	speech_act
colonialism	exploitation
streamed	float
zen	buddhism
piffle	nonsense
spill	liquid
revealing	speech_act
alienated	change
please	satisfy
armenian	asian
replacing	substitution
finding	discovery
plumbing	utility
bursts	change_of_integrity
extends	increase
laboratory	workplace
judging	decision_making
staring	look
salvage	commodity
rewards	consequence
jostling	shove
gulp	swallow
overuse	exploitation
airhead	simpleton
amateur	person
daredevils	adventurer
resentment	hostility
poem	literary_composition
screenwriters	scriptwriter
poet	writer
sneeze	reflex
heavyweights	boxer
checkout	inspection
shave	depilation
rapids	waterway
propaganda	information
inferior	follower
catapulting	propel
calculating	reason
commend	praise
spine	skeletal_structure
theology	discipline
icons	symbol
sands	seashore
guitar	stringed_instrument
imaginary	number
spins	rotation
comment	statement
americanized	change
portrays	represent
summertime	season
quirks	unfamiliarity
poetics	literary_study
guns	weapon
confronting	meet
fair	show
cinematographer	photographer
peroxide	oxidant
droning	intonation
critic	professional
slavery	subjugation
dresses	woman
potboiler	literary_composition
downplaying	inform
zip	relative_quantity
profession	occupational_group
arise	become
huskies	working_dog
keening	express_emotion
dressed	change
hammers	striker
cornpone	cornbread
cynics	unpleasant_person
doors	movable_barrier
wines	alcohol
spectrum	array
emperor	sovereign
snowball	sand_verbena
heartbreak	sorrow
diner	eater
triumphs	ending
church	religion
boiled	change_state
iii	digit
classical	music_genre
isolated	discriminate
pictures	representation
gimmick	drawback
ineptitude	unskillfulness
nick	blemish
fall	season
finishes	decorativeness
explains	inform
overshadowed	brood
undergo	change
delineate	show
homework	school_assignment
contrivance	device
idiocy	retardation
siege	blockade
exhaustion	fatigue
abstract	concept
upsets	agitation
dawns	hour
deep-sixed	discard
gutter	channel
paints	coating
appearance	quality
culture	society
fake	imitation
runs	score
first	rank
embellishment	expansion
wince	facial_expression
guru	religious_leader
nuances	meaning
perfect	tense
sanctimony	hypocrisy
roman	italian
to-do	disorder
exhausting	tire
conspiracy	agreement
spite	malevolence
theater	building
harmed	injure
nephew	kinsman
poky	correctional_institution
litmus	acid-base_indicator
perversity	unruliness
spits	cape
drawers	underpants
insights	perception
ill	disorder
ilk	kind
finished	end
rejection	act
spinning	handicraft
doctorate	academic_degree
goosebumps	reflex
dignified	honor
predicament	difficulty
fame	honor
tossed	fling
pond	lake
death	change
steal	purchase
deportment	trait
advice	proposal
according	match
powder	solid
error	nonaccomplishment
mishandled	fail
attendant	assistant
stylized	represent
swashbucklers	adventurer
paper	material
winds	weather
ruffle	adornment
complicity	guilt
steam	vapor
endeavour	undertaking
colored	black
camouflage	semblance
value	numerical_quantity
guts	fortitude
annex	addition
tinged	affect
listening	sensing
ruse	maneuver
subtitles	translation
enforced	compel
liberalism	political_orientation
haunting	pursue
fortune	phenomenon
acolytes	clergyman
lampoons	caricature
tricks	device
staged	re-create
rush	motion
fans	device
ins	agency
subtitled	supply
creeping	locomotion
stages	time_period
fleeing	scat
growth	organic_process
sweating	bodily_process
weave	design
fare	agenda
sweetheart	lover
texan	american
objects	physical_entity
shakes	building_material
scenarios	script
shaken	move
resolution	document
contorting	twist
fart	reflex
probation	trial_period
poor	people
graduate	scholar
farm	workplace
definitions	explanation
invented	create_by_mental_act
grief	sorrow
glimpses	look
poof	gay_man
persona	portrayal
enduring	permit
ingenue	actor
moviemaking	devising
harks	listen
pool	excavation
motorcycles	motor_vehicle
moratorium	delay
adapted	change
kraft	wrapping_paper
giggles	laugh
pearls	jewel
goulash	stew
shocks	stupefaction
charged	rush
pony	horse
jerky	meat
providing	give
fate	happening
dramatizing	write
weeks	time_period
criterion	system_of_measurement
primer	textbook
pore	hole
relays	passage
insistence	demand
manual	handbook
pork	meat
prowess	superior_skill
playfulness	levity
porn	creation
craftsmanship	skill
founding	beginning
close	end
chemistry	natural_science
winners	contestant
grieving	suffer
irk	anger
instalment	broadcast
scented	cause_to_be_perceived
massacres	murder
embarrassment	shame
disdain	dislike
actresses	actor
screwing	sexual_intercourse
fast	abstinence
grating	barrier
invasion	penetration
trials	attempt
workout	effort
precedent	example
falsehoods	statement
grocery	marketplace
characterization	description
crashing	descend
malaise	discomfort
frontal	adornment
nine	digit
communicate	convey
astronauts	traveler
senses	awareness
foreman	supervisor
annoyance	psychological_state
blonde	person
acclaim	approval
pushes	propulsion
epiphany	manifestation
acid	compound
copycat	person
post	position
masquerade	party
stomps	social_dancing
blush	good_health
repeating	continuance
coping	brick
wearer	user
pose	affectedness
erupt	begin
its	engineering
wrapping	covering
succumbing	accept
mesmerised	charm
respect	detail
shelf	support
retreat	withdrawal
fusion	union
ache	pain
shell	ammunition
guys	man
carnivore	placental
milquetoast	coward
retread	car_tire
semen	liquid_body_substance
applauded	gesticulate
trounce	beat
wallflower	flower
billy	club
production	act
plotted	plan
united	join
yawner	person
directors	administrator
choose	decide
treachery	disloyalty
anchors	hook
paste	composition
politesse	courtesy
miles	linear_unit
skipped	neglect
undo	change_by_reversal
burgeoning	grow
grandeur	elegance
mixture	substance
strikes	job_action
cheats	rye_grass
infuses	drill
bills	legal_document
surveillance	police_work
hide-and-seek	child
lyrics	text
pour	move
infused	drill
drenched	flood
improvement	transformation
pyrotechnics	brilliance
tarantula	wolf_spider
ivy	vine
objectivity	judgment
histrionics	performance
uniqueness	individuality
clone	double
pasts	time
pledge	security_interest
pushed	move
pasty	meat_pie
college	body
russians	native
configurations	design
arithmetic	pure_mathematics
sanity	mental_health
motherhood	kinship
variation	change
shag	tobacco
number	amount
liana	vine
kitsch	art
slack	debris
centers	area
property	possession
debris	rubbish
stills	photograph
jerry	german
viewpoint	position
luster	brightness
nothing	relative_quantity
testing	experiment
volumes	measure
sporting	have
handle	appendage
isolation	separation
resorts	hotel
impacts	contact
tough	combatant
script	dramatic_composition
animation	being
masses	group
patronizing	support
waltzed	dance
woodman	rustic
fiddle	bowed_stringed_instrument
catholic	christian
silver	conductor
urges	motivation
fundamentals	principle
fathers	parent
city	municipality
highbrow	intellectual
torments	pain
courage	spirit
local	public_transport
bloodsucker	annelid
dazed	blind
bubble	globule
advertised	announce
yield	production
blaxploitation	exploitation
decisions	choice
saddled	attach
drained	run
rests	part
filled	change
satisfaction	contentment
alternates	stand-in
marmite	soup
demographic	statistic
heartening	encourage
pablum	cereal
sham	imitation
lioness	lion
filler	sealing_material
bubbly	sparkling_wine
governance	body
mantra	motto
precision	exactness
catcher	infielder
milks	beverage
catches	drawback
spiced	change
points	component
absorbed	sorb
copies	written_record
reap	gather
presume	expect
stocked	have
qualify	suffice
border	boundary
read	publication
slackers	idler
finale	conclusion
telegrams	message
touch	contact
derailed	sabotage
backhanded	hit
couples	pair
real	complex_number
admission	entrance
clock	timepiece
englishmen	english_person
quadrangle	polygon
skateboarder	skater
unit	definite_quantity
hybrid	word
panorama	visual_percept
characterisation	description
tattoos	bugle_call
bombards	bass
coupled	join
collect	prayer
gear	wheel
adherents	follower
entertaining	socialize
ridiculousness	nonsense
humankind	group
ringside	seating
domineering	strong-arm
cleverness	creativity
disappoint	thwart
bristles	fiber
jolting	move
today	present
construction	creating_from_raw_materials
orchestrating	score
predict	guess
saying	speech
universal	rule
fifteen	large_integer
radical	unit
degenerating	worsen
blunt	weaken
warnings	informing
neurotic	sick_person
batman	attendant
minute	time_unit
abbreviated	decrease
blaring	noise
hypothesis	proposal
ferment	turbulence
puppets	figure
comprehend	understand
reason	rational_motive
germanic	indo-european
ship	vessel
strolls	walk
scottish	english
subcontinent	landmass
exalted	praise
sacrificing	release
afterlife	life
humbling	change
identification	determination
uplifting	rise
jam	conserve
modicum	small_indefinite_quantity
annual	plant
jar	vessel
gentle	calm
underbelly	bottom
goodness	quality
shopping	buying
jaw	bone
reef	ridge
using	mistreatment
deeds	activity
reconciled	harmonize
flamboyance	ornateness
sexiness	sexual_desire
pregnancy	physical_condition
marquee	tent
reek	smell
demand	request
reel	film
rings	gymnastic_apparatus
photographs	representation
geek	performer
turkey	domestic_fowl
letter	document
alternatives	decision_making
oleander	poisonous_plant
telescope	magnifier
innuendo	implication
photography	pictorial_representation
imitating	reproduce
accuse	charge
mobility	quality
doses	medicine
hymn	religious_song
housing	structure
ducts	passage
predecessor	precursor
aristocracy	elite
handed	transfer
doubting	disbelieve
worth	indefinite_quantity
visionary	person
tactic	plan_of_action
somebodies	causal_agent
notion	idea
deteriorates	decay
openness	spacing
taken	act
takes	income
pokey	correctional_institution
caper	shrub
broken	end
outweigh	surpass
shear	deformation
intolerance	impatience
stunts	feat
olives	fruit
shifted	change
dilemma	perplexity
solace	comfort
forwards	basketball_player
grips	grasping
castle	mansion
centered	refer
lifetime	time_period
bloodshed	murder
losers	contestant
individuals	causal_agent
challenging	contest
repeated	tell
outshine	shine
debate	discussion
miscalculations	mistake
inhalant	gas
preach	lecture
jet	airplane
herring	saltwater_fish
subjugate	oppress
fragmented	break
machinations	plot
worry	negative_stimulus
watches	timepiece
flattering	praise
sanguine	red
motives	psychological_feature
pondering	think
telephone	electronic_equipment
delicious	eating_apple
worse	bad
rein	strap
bleed	exhaust
screaming	cry
difficulty	effort
adorns	change
longer	person
signals	communication
anti-semitism	racism
colleagues	associate
parties	organization
worst	result
selling	commerce
obsessions	irrational_motive
plainness	purity
leaving	act
sequels	result
shop	mercantile_establishment
distance	spacing
attract	pull
show	entertainment
critique	criticism
description	statement
haywire	wire
augmented	increase
fireballs	meteor
shot	propulsion
cracked	change
pizza	dish
chimps	great_ape
street	thoroughfare
shoe	footwear
situates	determine
molestation	sexual_assault
indomitability	strength
outage	indefinite_quantity
palaver	flattery
substance	matter
vagueness	unclearness
cracker	bread
compensated	balance
sibling	relative
grind	learner
earnestness	gravity
discomfort	condition
cranked	travel
hype	promotion
absorbing	sorb
stranger	intruder
fringes	boundary
milestones	marker
doomed	people
gurus	religious_leader
fancy	misconception
rebel	confederate_soldier
aborted	end
rent	annuity_in_advance
carpenter	woodworker
glancing	look
proficiency	competence
billing	request
humiliated	hurt
channeling	bring
drudgery	labor
flirts	woman
crises	situation
canvas	fabric
understatement	statement
waits	pause
captivated	attract
anxieties	psychological_state
hollow	cavity
epic	poem
spirals	curve
sprawling	position
sunday	rest_day
gems	art
captivates	attract
rely	believe
evaded	avoid
bounds	extremity
refined	better
style	property
merited	be
jimmy	crowbar
flick-knife	pocketknife
cherry	wood
elicited	make
harry	annoy
freezers	electric_refrigerator
guard	defender
settle	bench
self-control	control
australian	inhabitant
babies	child
vehicle	conveyance
beheadings	execution
voyeur	spectator
freedom	state
cushion	damper
criminals	principal
overproduced	grow
plateau	highland
bender	tool
adored	love
architecture	building
scorpion	person
insider	corporate_executive
levity	feeling
stress	prosody
consolation	comfort
shortcomings	disadvantage
vocalized	pronounce
cussing	express
leers	contempt
nomination	appointment
contrivances	device
fashioning	production
grounding	education
ditched	abandon
giggle	laugh
luck	condition
mature	develop
conspiracies	agreement
heathers	heath
transforms	change
reeking	suggest
bonds	attraction
minded	object
influence	power
giggling	laugh
magnolia	bark
responsibilities	social_control
detailing	description
pianist	musician
rainbows	bow
wrapped	cover
videotape	tape
episodes	happening
fixating	bind
crisis	situation
forgiven	concede
crafted	fashion
addiction	physical_condition
glamour	beauty
vaudeville	variety_show
misguided	lead
glimpse	look
detective	policeman
parting	departure
phrase	construction
veteran	serviceman
bones	percussion_instrument
reruns	broadcast
daily	newspaper
affluence	wealth
sheds	outbuilding
harps	chordophone
ropes	line
redundancies	repetitiveness
job	activity
daughter	female_offspring
autopsy	examination
mommy	mother
resurrecting	resuscitate
captain	commissioned_military_officer
footing	status
rotting	decay
sidewalks	walk
highlight	detail
adjective	modifier
bustling	move
joy	emotion
discards	object
sheer	turn
clown	fool
miracle	happening
imitation	doctrine
compliment	praise
denouement	result
adds	syndrome
clout	target
rest	part
miscalculates	misjudge
original	creation
cautions	attentiveness
teleprompter	prompter
slapstick	comedy
insensitivity	inability
gets	return
kingdom	sphere
terrier	hunting_dog
afternoon	day
puppet	figure
bedeviled	harass
investigation	inquiry
front	side
petite	size
recessive	allele
plane	heavier-than-air_craft
equivalent	cognition
stupid	simpleton
howler	joke
constricted	tighten
projects	work
pursuers	follower
wedge	triangle
stripped	take
flickering	move_back_and_forth
plague	epidemic_disease
fascinate	matter_to
canon	rule
offer	speech_act
elicits	make
hooliganism	destruction
fixated	bind
complex	whole
humidity	wetness
bumbling	fail
cinema	medium
rubbish	waste
gaining	obtain
demeaning	humiliate
molly	topminnow
metropolis	municipality
masturbation	autoeroticism
scintillating	emit
astonishing	surprise
tequila	liquor
plastic	solid
plans	idea
commiserating	feel_for
plant	building_complex
kiosks	closet
drive	propulsion
expound	clarify
aristocrats	leader
traits	attribute
spaghetti	pasta
disrobed	take_off
ransacked	take
sixth	rank
sailor	skilled_worker
discouraging	disapprove
audiences	gathering
national	person
masseur	massager
indicate	tell
pabulum	food
customers	consumer
jock	contestant
mannerisms	peculiarity
contain	include
words	speech
benefited	get
medicine	medical_science
matchmaking	mediation
chimes	percussion_instrument
gifted	enable
difficulties	effort
escapades	undertaking
digits	integer
windshield	screen
spider	arachnid
leaping	jump
testimonial	evidence
rooms	apartment
stamina	endurance
needless	simple_leaf
developed	create
larded	cook
shouts	utterance
smallness	size
contact	interaction
unsettling	upset
detachment	indifference
disadvantage	liability
searches	activity
pretentiousness	inelegance
garbage	waste
pulls	propulsion
epitaph	inscription
parts	environment
helps	activity
western	feature
macho	male
party	organization
duties	social_control
reams	large_indefinite_quantity
theatrical	performance
sparkles	expression
sources	point
trained	teach
goose	anseriform_bird
trembling	motion
songbird	oscine
depress	discourage
lucks	condition
disappoints	thwart
enveloped	cover
salute	recognition
riddle	problem
judaism	religion
signs	clue
captured	represent
catharsis	purge
lump	agglomeration
views	orientation
hardwood	wood
tenderness	affectionateness
directed	order
captures	acquiring
wearing	geological_process
dinner	meal
cleaving	tear
trajectory	mechanical_phenomenon
breed	animal_group
chitchat	chat
fulfills	complete
realm	sphere
lull	pause
athleticism	energy
appealing	challenge
merges	integrate
elaborate	clarify
expert	person
fulfill	complete
crowd	gathering
tirade	declamation
sick	people
mikes	electro-acoustic_transducer
candor	impartiality
rerun	broadcast
blacks	achromatic_color
sputters	noise
maiden	girl
compulsive	person
corner	area
majority	number
neurosis	mental_disorder
join	connection
helms	steering_system
costume	attire
reworked	work
gears	wheel
cradles	baby_bed
sentence	string_of_words
bikes	motor_vehicle
director	administrator
chasing	pursue
imitations	doctrine
aggressiveness	drive
accents	pronunciation
ordinary	judge
drink	helping
creepy-crawly	animal
aftertaste	afterimage
verdict	finding
stereo	reproducer
john	room
impulses	motivation
tackling	confront
recommending	propose
reporters	communicator
works	building_complex
brought	transport
signpost	sign
focuses	concentration
drawbacks	disadvantage
extras	actor
plate	base
emerged	appear
flowering	growth
thinking	higher_cognitive_process
cycle	time_interval
world	natural_object
freaks	mutant
composed	constitute
misses	woman
prejudice	partiality
flails	implement
banality	remark
guardian	preserver
fanatic	enthusiast
telegraphs	apparatus
optic	sense_organ
side	region
bread	baked_goods
break	happening
composer	musician
drips	flow
willingness	disposition
deceit	dishonesty
joke	wit
comfort	condition
bacon	cut_of_pork
century	time_period
hide	animal_skin
report	document
skewed	reorient
emerges	appear
skateboarding	skating
powers	quality
married	person
disquieting	disturb
pessimism	despair
auto	motor_vehicle
surfing	water_sport
autopilot	unconsciousness
lament	complaint
knees	hinge_joint
sign	clue
outrage	anger
cotton	plant_fiber
expresses	mail
high	degree
skirts	cloth_covering
pillowcases	bed_linen
falls	perianth
split	acrobatic_stunt
immerse	penetrate
lust	sexual_desire
borstal	reformatory
champagne	sparkling_wine
exudes	excrete
neuroses	mental_disorder
absurdities	nonsense
grenade	bomb
travails	parturition
floats	time_interval
descends	travel
pokes	pokeweed
level	property
roots	condition
modernized	regenerate
lush	drunkard
rambles	amble
establish	open
synthetic	compound
belongs	be
proclaim	entitle
attached	connect
focused	think
graffiti	decoration
modernizes	regenerate
bunch	agglomeration
jolt	blow
errors	nonaccomplishment
parents	genitor
consumed	eat
birthday	anniversary
candy	sweet
scores	large_indefinite_quantity
recipe	direction
parable	story
total	whole
pursued	hunted_person
adrenaline	catecholamine
astounding	surprise
wreaks	make
consumers	user
ills	disorder
loser	contestant
savage	primitive
informs	communicate
plays	dramatic_composition
crudeness	wild
social	party
interesting	arouse
cross	structure
relying	believe
raised	increase
control	power
demanding	request
compositions	placement
drill	tool
coloured	influence
hilarity	gaiety
conjure	make
lobby	room
scored	gain
howling	utterance
pulse	wave
facades	front
stumble	gait
newcomer	novice
cunning	shrewdness
ensnare	deceive
upper	berth
mummy	mother
spiritualism	theological_doctrine
episode	happening
commanding	dominate
decency	propriety
behalf	stead
somewhere	location
scene	area
objective	goal
bathtub	vessel
no-brainer	undertaking
improbabilities	uncertainty
lighten	cheer
self-sacrifice	cooperation
overflows	flow
raises	increase
accomplishments	action
exhibit	evidence
faltering	pause
publishing	commercial_enterprise
exterminator	killer
lighted	lighten
appreciates	acknowledge
chateaus	country_house
sexpot	girl
spirituality	property
brilliance	brightness
swathe	bandage
remaining	be
accept	evaluate
zigzag	angular_shape
ethnicities	quality
yearning	desire
collie	shepherd_dog
appreciated	acknowledge
mystic	believer
roughage	foodstuff
sermonize	preach
access	right
primitive	person
delving	remove
curtains	blind
teens	time_of_life
keg	containerful
recite	perform
captions	exception
artists	creator
ken	knowing
crippled	weaken
specificity	particularity
fancies	misconception
engulfed	concentrate
key	device
situations	state
surprised	affect
misanthropy	hate
plaguing	afflict
addicted	habituate
jaunt	journey
loads	large_indefinite_quantity
lighter	fuel
launch	motorboat
josh	tease
asphalt	paving
wiseacre	upstart
surprises	astonishment
hill	natural_elevation
cloak	covering
knucklehead	stupid
cricket	orthopterous_insect
mortality	impermanence
stoner	attacker
boasts	speech_act
hallelujah	praise
stones	natural_object
fourth	rank
self-hatred	shame
laughing	express_emotion
ignite	burn
sexuality	physiological_property
guiding	control
revelation	speech_act
capitalizes	profit
snipes	shorebird
quest	search
conjured	make
variant	deviation
conjures	make
dynamic	incentive
extreme	degree
hustling	move
demeanor	trait
oppositions	action
zings	sound
studios	workplace
athlete	contestant
sink	plumbing_fixture
degree	property
borscht	soup
inquiries	problem_solving
discord	disorder
dismay	despair
hint	suggestion
recklessness	unthoughtfulness
sing	interpret
demonstrate	show
sublime	change
records	evidence
figures	illustration
kid	juvenile
figured	evaluate
monument	structure
recreated	stimulate
blues	black_music
kin	relative
assesses	body_part
initiation	ceremony
shoddy	wool
drawings	artwork
mingles	change
conflicts	group_action
warlord	military_leader
anonymity	obscurity
charting	map
bounces	elasticity
morbidity	incidence
virtue	good
compulsion	irrational_impulse
punching	hit
types	kind
strokes	maneuver
corrupt	change
technology	application
contours	isometric_line
typed	write
pairing	sexual_activity
stroked	touch
nights	time_period
ones	digit
recreates	stimulate
bluff	bank
compromise	cooperation
brent	goose
reach	limit
backed	approve
fringe	boundary
react	act
foreground	view
calibrated	adjust
hiss	noise
kissing	foreplay
justify	confirm
sight	visual_percept
elbowed	jostle
teeth	set
sisterhood	kinship
sprouts	plant_organ
simulate	reproduce
collar	band
negatives	denial
lending	disposal
thrills	exhilaration
monsters	imaginary_being
joys	emotion
jeopardy	danger
pitfalls	difficulty
seventeen	large_integer
following	multitude
juvenile	person
provoked	make
trudge	hike
stickiness	viscosity
complacency	satisfaction
wear	deterioration
impress	seizure
seeing	perception
martinet	authoritarian
restate	tell
lean	position
provokes	make
assert	insist
pared	decrease
leap	jump
place	point
regular	patron
informed	communicate
deflated	collapse
observation	measurement
entrapment	defense
tired	devolve
tremble	reflex
payoff	payment
lead	advantage
kibbitzes	comment
fraction	chemical
hits	feat
spaceship	spacecraft
expect	evaluate
elegance	quality
tangled	involve
highlights	detail
drying	change
assess	body_part
gentlemen	man
miracles	happening
resembles	match
passage	change_of_state
bombs	explosive_device
sausage	meat
undertones	tone
undercuts	material
routes	line
assets	possession
setups	equipment
armchair	chair
plain	land
describing	set_forth
offal	variety_meat
justice	natural_virtue
pantheon	collection
mechanisms	chemical_process
mileage	distance
individual	causal_agent
comparing	examination
excitement	joy
regards	detail
cadence	poetic_rhythm
blueprint	plan
outrageousness	excess
burrito	dish
person	causal_agent
testimony	evidence
retaliation	return
glitter	brightness
week	time_period
sociology	social_science
musicians	performer
preaching	address
weep	express_emotion
romantics	idealist
bewitched	attract
dragonfly	odonate
ready	readiness
studies	examination
acknowledges	declare
player	contestant
contenders	contestant
orientation	placement
balloon	lighter-than-air_craft
limited	public_transport
match	lighter
rethink	reversal
played	compete
accent	pronunciation
balancing	equalization
clutches	grasping
ladles	vessel
explosive	chemical
prepare	change
bludgeoning	coerce
entwined	join
fifty	large_integer
surgeon	doctor
nowadays	time
copout	failure
smacks	blow
equations	mathematical_statement
twinkling	moment
freshening	regenerate
moviegoer	spectator
eroticism	sexual_arousal
timelessness	being
legs	stamina
endorses	approve
contemplative	person
angling	fishing
solid	matter
narrative	message
circular	ad
relegated	submit
diplomacy	negotiation
latino	american
size	magnitude
left	position
reserved	withhold
temper	annoyance
tormentor	oppressor
downer	drug_of_abuse
eleven	large_integer
imitator	deceiver
object	physical_entity
mined	exploit
infinite	attribute
attics	floor
suffice	satisfy
notable	celebrity
tastelessness	unappetizingness
balanced	match
elect	elite
example	information
minds	cognition
midway	tract
characters	imaginary_being
padre	chaplain
corners	area
balances	equilibrium
shlockmeister	merchant
narcissists	selfish_person
spanning	cover
stirring	agitation
zombie	dead_person
quiet	calmness
policy	plan_of_action
hushed	change
elves	atmospheric_electricity
glucose	aldohexose
address	code
troll	mythical_monster
falters	pause
tie-in	fastener
beliefs	content
accumulates	store
ramble	amble
heightened	increase
police	force
glitz	tastelessness
throw	propulsion
overstuffed	stuff
stature	esteem
thank	convey
fifth	united_states_liquid_unit
accumulated	store
motorized	equip
wheels	machine
portrayals	word_picture
romanced	act
lapping	covering
confront	meet
cathartic	medicine
torturing	persecution
anchoring	fasten
romances	relationship
illiterate	ignoramus
festers	sore
hardened	change
making	production
check	draft
resists	elude
drumming	percussion
sleeper	rester
beacon	visual_signal
survivors	unfortunate
supposed	speculate
warden	lawman
bursting	break
translating	repeat
moaning	utter
lens	optical_device
chefs	cook
society	social_group
expanded	grow
nowhere	obscurity
romantic	idealist
flows	change_of_location
anticipation	expectation
averting	prevention
margarita	cocktail
tutorial	session
reinforcement	operation
dickens	exclamation
spoil	stolen_property
lend	change
infirmity	unfitness
enhancing	intensify
welt	injury
pilot	aviator
ticket	commercial_document
cheek	feature
bisexual	sensualist
swords	weapon
realized	know
concentrate	ore
expose	exposure
cheer	approval
tundra	plain
explosion	discharge
translation	written_record
well	excavation
realizes	know
handling	manual_labor
personnel	organization
splash	noise
ambitions	desire
xerox	copy
porcelain	ceramic_ware
satin	fabric
myth	story
fearing	worry
experiment	scientific_research
implication	inference
consigned	abandon
campion	flower
considering	think
doldrums	inaction
moviegoers	spectator
philosophers	scholar
gaiety	happiness
aimlessness	meaninglessness
bringing	transportation
doofus	simpleton
schools	educational_institution
binary	star
spots	symptom
bleakness	gloom
crazy	lunatic
orders	command
sparking	initiate
huckster	seller
welled	surface
boomers	person
deferred	delay
successor	peer
enlightenment	education
tabloids	journalism
rip-off	robbery
matter	concern
irony	wit
carousel	conveyer_belt
walls	partition
rails	bar
spin-off	product
deckhand	mariner
spout	opening
noise	sound
self-preservation	preservation
succession	temporal_arrangement
product	commodity
stupidity	inability
reminder	message
lover	person
loves	emotion
revels	merrymaking
trots	locomotion
sanitised	clean
produce	food
hates	emotion
hippopotamus	even-toed_ungulate
cheat	rye_grass
walks	locomotion
perfected	better
retooled	reorganize
thanksgiving	feast_day
witch	occultist
wreaked	make
tormented	pain
anecdote	report
holly	angiospermous_tree
roars	noise
spoof	caricature
lingerie	underwear
traveler	person
minor	juvenile
pitted	confront
hostile	military_personnel
yelling	cry
fuel	substance
pleas	entreaty
smuggling	importing
stupidities	inability
lab	workplace
pray	commune
bugged	torment
lad	male
crawl	motion
monologue	speech
nightmares	situation
paean	praise
function	mathematical_relation
lan	computer_network
raise	increase
puberty	time_of_life
hated	dislike
traffic	collection
surfer	swimmer
mindset	attitude
miscast	cast
law	collection
pomposity	inelegance
cliques	set
comparison	examination
clones	double
lay	song
pitched	fling
crave	desire
less	autoimmune_disease
suspects	person
adventure	undertaking
conflicting	contrast
condition	state
improve	change
shining	work
wending	travel
environs	geographical_area
piercing	penetrate
university	body
censure	disapprobation
chatter	talk
technique	method
characterizations	description
levy	charge
wound	injury
sensationalism	message
teacher	educator
existentialism	philosophical_doctrine
repressed	oppress
coincidence	accident
bittersweet	nightshade
floor	horizontal_surface
awakens	change
possibility	expectation
retelling	re-create
sucking	consumption
wounded	people
improbability	uncertainty
realizing	know
distinguished	identify
chooses	decide
opening	space
heartstrings	compassion
gander	goose
doctor	medical_practitioner
derring-do	feat
lengths	dimension
bemused	upset
inflate	increase
lambs	young_mammal
spoken	communicate
dumbness	stupidity
equilibrium	situation
distinguishes	identify
flops	computer_operation
sport	diversion
maintenance	repair
contemporaries	people
trope	rhetorical_device
lingered	persist
prey	victim
lieutenant	commissioned_military_officer
led	diode
absorb	sorb
steers	guidance
supply	indefinite_quantity
resuscitate	bring_to
horrified	frighten
mountain	natural_elevation
integrity	state
docs	medical_practitioner
pact	written_agreement
merge	integrate
advises	hash_out
les	autoimmune_disease
press	urgency
dough	concoction
unmentionable	garment
cares	work
night	time_period
pace	rate
ballet	stage_dancing
vulnerability	danger
courtesy	politeness
pack	large_indefinite_quantity
patchwork	theory
labels	description
rendered	make
padded	overstate
abhors	hate
supple	change
whirls	movement
metaphors	trope
items	part
bravado	ostentation
villainess	villain
thirty	large_integer
workman	employee
stagings	production
entertainment	diversion
nudity	condition
document	writing
anteing	bet_on
killing	fatality
rapport	affinity
dollars	monetary_unit
proving	be
strains	deformation
scenario	script
does	executive_department
ignites	burn
rewritten	write
divorce	separation
graphic	picture
distortions	damage
situation	state
peekaboo	child
clause	construction
empathy	sympathy
leys	grassland
clad	change_state
dodge	scheme
thirst	drive
refused	react
authenticity	credibility
moods	feeling
solipsism	philosophical_doctrine
refuses	waste
stuffed	cram
producers	maker
claw	horny_structure
admitting	declare
prayer	worship
collapses	illness
clan	social_group
fashion	property
blended	mix
insurance	security
medical	examination
dazzle	brightness
swipes	stroke
principle	generalization
two-thirds	common_fraction
lie	falsehood
statecraft	wisdom
source	point
exhuming	excavate
smell	sensation
blender	mixer
prim	change
separation	state
feathers	animal_material
vitality	energy
lit	literary_study
lushness	abundance
bias	partiality
slapping	strike
dogs	canine
homes	residence
tension	strain
chest	body_part
involves	refer
beatings	fight
caustic	compound
doubt	cognitive_state
bolstered	reinforce
merit	worth
athletes	contestant
develop	create
nurses	health_professional
involved	refer
converted	change
crossroads	community
armenians	asian
aching	pain
hammering	blow
ballroom	room
overall	work-clothing
page	leaf
full	phase_of_the_moon
meanders	curve
pepper	true_pepper
destiny	happening
cards	game
panache	elegance
motivation	psychological_feature
aspects	feature
soured	change_state
millennium	time_period
specter	apparition
dogmatism	intolerance
megalomaniac	egotist
cared	feel_for
squanders	use
triteness	unoriginality
tamer	animal_trainer
wreckage	part
enhance	intensify
convention	meeting
antiseptic	medicine
pain	symptom
critiquing	evaluate
center	area
refusal	denial
titles	heading
advised	hash_out
pair	set
anomie	isolation
manage	succeed
equal	person
upstaged	treat
cooler	refrigerator
gravity	attraction
paid	give
extravaganza	entertainment
veering	turn
funk	depression
titled	name
mesmerize	charm
immortals	celebrity
studio	workplace
parking	room
cheapening	worsen
dilettante	amateur
palm	area
celebrities	important_person
resonances	physical_phenomenon
three	digit
ordeal	experience
premise	postulate
virtuosity	skill
suppression	growth
season	time_period
pale	strip
hardware	weaponry
typifies	typify
trivializes	understate
threw	propel
players	contestant
roads	anchorage
mythology	collection
whimper	complaint
provide	give
slam-dunk	affect
geeks	performer
mick	irishman
preoccupations	idea
chuckling	laugh
primary	election
anarchists	radical
log	wood
enterprise	undertaking
falcon	hawk
accidental	musical_notation
lot	large_indefinite_quantity
glasses	optical_instrument
fuse	electrical_device
computer	machine
pros	athlete
roach	hairdo
wholesale	selling
aided	support
prom	ball
low	air_mass
angels	spiritual_being
indulging	gratification
contradiction	opposition
fuss	agitation
meant	convey
wealth	financial_condition
means	implementation
performers	entertainer
prod	encouragement
initial	letter
fury	anger
baboon	old_world_monkey
contemplation	stare
zealanders	dane
absurdity	nonsense
fellow	male
louts	clumsy_person
awed	frighten
advancing	travel
interests	curiosity
crushing	prevention
door	movable_barrier
quick	area
distinguishing	identify
husband	spouse
experience	education
blasting	make_noise
dodges	scheme
dodger	deceiver
zone	topographic_point
stammers	speech_disorder
minutiae	detail
betters	good
papa	father
intro	informing
affair	concern
combination	collection
sparks	flash
adept	expert
curiosity	cognitive_state
minutes	written_record
sacrifice	act
shriveled	decrease
particular	fact
dong	vietnamese_monetary_unit
puzzling	confuse
pause	time_interval
congratulate	praise
rainbow	bow
residents	inhabitant
expedience	advantage
cohesion	connection
superman	leader
ease	quality
overrun	production
mike	electro-acoustic_transducer
relied	believe
part	relation
mafia	syndicate
insulted	hurt
constructs	idea
jealousy	envy
feminized	change
conversations	speech
notches	indentation
bike	motor_vehicle
principal	debt
elegy	poem
east	cardinal_compass_point
relies	believe
deuces	tie
african-american	american
relief	comfort
elvis	lysergic_acid_diethylamide
park	tract
lisping	pronounce
undergrad	collegian
washed	serve
rhapsodize	tell
aristocrat	leader
zoom	rise
seeking	search
tides	periodic_event
dope	cannabis
ears	sense_organ
economics	social_science
someone	causal_agent
dramas	dramatic_composition
gratitude	feeling
earn	get
terrors	fear
interaction	action
splendour	brightness
persuades	influence
fitting	improvement
bucked	endeavor
gaping	look
agitprop	propaganda
coherence	connection
smiles	facial_expression
reductions	change_of_magnitude
evolved	create_by_mental_act
sketched	draw
boobs	simpleton
compassion	sympathy
beasts	organism
asylum	shelter
lux	illumination_unit
eighties	decade
path	course
crack	opening
bind	hindrance
depending	be
soporific	drug
startled	shock
evolves	create_by_mental_act
sketches	drawing
record	evidence
grotesque	art
zingers	remark
prevention	hindrance
accepting	evaluate
pass	accomplishment
mile	linear_unit
past	time
profile	chart
mourning	sadness
milk	beverage
bill	legal_document
dorm	building
eclipses	interruption
bile	digestive_juice
mill	plant
bucket	vessel
hokum	message
dose	medicine
scandals	gossip
bathing	diversion
lesbian	homosexual
profiling	identification
eats	fare
crafting	fashion
assigned	appoint
smear	defamation
adult	person
relative	person
monte	card_game
thriller	adventure_story
hypocrisies	pretense
bloated	swell
thrilled	stimulate
annoyed	displease
thrives	grow
chafing	tenderness
mine	excavation
dramatized	write
mind	cognition
mini	skirt
dots	disk
reverence	emotion
emergence	beginning
apartheid	social_policy
disorientated	confuse
involve	refer
requisite	thing
elude	escape
touches	contact
forcefulness	intensity
multiplex	telecommunication
retrograde	orb
showcase	setting
disintegrating	change_integrity
platitudes	remark
slobbering	salivate
added	increase
gunfight	fight
perdition	imaginary_place
ransacks	take
glides	phone
emergency	crisis
cheated	victimize
down	feather
launching	propulsion
shifting	motion
peppered	zest
brings	transport
adding	increase
fairytale	narrative
clue	indication
club	baseball_team
boundaries	extremity
lunacy	insanity
seated	put
meshes	linear_unit
whoop	cry
espionage	spying
alterations	happening
intriguing	matter_to
chiller	excitation
frosting	topping
regarding	think
month	time_period
chilled	depress
paws	animal_foot
acres	real_property
chuck	fare
pawn	pledge
needles	simple_leaf
squeeze	compression
bidder	applicant
importance	value
worthy	important_person
title	heading
heartland	region
mist	fog
miss	woman
delights	pleasure
conveying	transfer
plucking	pull
harvesting	gather
doorstep	sill
bite	wound
doze	sleeping
disgusting	stimulate
human	hominid
continuation	activity
poetry	writing_style
prince	aristocrat
knockout	woman
soul-searching	introspection
stirs	disturbance
ticks	sound
ecstasy	emotional_state
retro	fashion
blessed	raise
permission	approval
generalities	idea
cesspool	cistern
henry	inductance_unit
fiend	unpleasant_person
beach	geological_formation
universe	natural_object
interpret	understand
individuality	trait
blanket	bedclothes
mire	bog
pays	regular_payment
ragbag	assortment
knockoff	copy
brothers	male_sibling
exhausted	tire
discount	decrease
fascinated	matter_to
charisma	attractiveness
relish	enjoyment
distillation	natural_process
supplies	indefinite_quantity
fascinates	matter_to
bollywood	film_industry
blacken	discolor
feat	accomplishment
fear	emotion
melange	assortment
fudged	cheat
inspection	examination
adversity	misfortune
agendas	plan
bits	small_indefinite_quantity
torrent	rain
appreciation	understanding
sense	awareness
classification	grouping
blacked	discolor
pretension	artificiality
printed	produce
field	tract
plucks	fearlessness
served	suffice
messages	communication
opens	area
baseball	ball_game
realities	experience
evaluate	evaluate
ooze	matter
upset	agitation
serves	tennis_stroke
cloying	supply
millisecond	time_unit
skin	body_covering
tailor	garmentmaker
skip	gait
stifles	joint
unmentionables	garment
sanders	power_tool
targets	reference_point
mention	remark
thrillers	adventure_story
laundry	garment
skirmishes	fight
man	adult
stifled	suppress
insinuating	bring_in
squirts	cipher
map	representation
twenty	large_integer
mar	gregorian_calendar_month
frankenstein	agency
mat	floor_cover
may	gregorian_calendar_month
supplied	give
insinuation	implication
max	gamma_hydroxybutyrate
bless	raise
fudges	candy
addict	enthusiast
murders	homicide
virtuoso	expert
obscured	hide
spectacles	optical_instrument
bespeaks	tell
unseen	belief
contemplates	view
awfulness	unpleasantness
feet	vertebrate_foot
self-esteem	pride
fees	fixed_charge
snowman	figure
opera	classical_music
tacked	fasten
sprung	move
bonus	positive_stimulus
presiding	control
recognition	acceptance
feel	awareness
disinterest	tolerance
aisle	passage
karen	tibeto-burman
textbook	book
ideal	idea
vagina	duct
comedy	drama
hamming	acting
equipment	instrumentality
ideas	content
interrupted	break
pressure	physical_phenomenon
becomes	change_state
flavours	atmosphere
fencer	combatant
feed	food
chuckle	laugh
pessimists	skeptic
entries	written_record
recesses	abeyance
directions	path
background	inheritance
lists	database
shmear	batch
zeitgeist	spirit
underplayed	act
blend	mix
lulled	calm
harvests	output
ushered	lead
conceive	create_by_mental_act
symbols	signal
nonsense	message
breath	bodily_process
men	force
vampire	evil_spirit
sitcom	comedy
flinching	move
contrasts	opposition
garbled	misrepresent
twaddle	nonsense
submerged	sink
lullaby	song
peppering	zest
absorbs	sorb
depicted	represent
celluloid	thermoplastic
dismember	kill
structure	artifact
surveyed	analyze
masculine	gender
orange	citrus
fright	emotion
newfoundland	dog
biscuit	quick_bread
conceits	pride
mercy	lenience
messing	eat
interpreting	explanation
craftsmen	professional
depend	be
danger	condition
crash	noise
granted	give
patch	marking
character	imaginary_being
consummate	carry_through
aggrandizing	overstate
above	section
prophecies	prediction
stick	implement
tales	message
resident	inhabitant
goals	content
comprise	be
height	dimension
drowns	cover
scratching	noise
eludes	escape
beaten	get_the_better_of
frozen	stand_still
urbanity	courtesy
received	get
flood	geological_phenomenon
quality	attribute
conveys	impart
animal	organism
boost	aid
receives	get
invested	spend
shared	overlap
components	part
crossover	organic_process
mib	computer_memory_unit
association	organization
believe	accept
shares	assets
fell	animal_skin
roster	list
confrontations	challenge
outnumber	total
glance	look
documentaries	movie
boots	footwear
seesawing	play
mix	concoction
destruction	termination
holes	opening
booty	stolen_property
dirty	change
trickster	troublemaker
bloodstream	blood
stiff	man
middle	area
strategies	plan_of_action
renewal	restoration
appeal	request
appear	be
diary	writing
conjuring	magic
negate	deviate
collaboration	cooperation
swank	elegance
associated	think
holds	grasping
melted	dissolve
open	area
justifying	confirm
berry	edible_fruit
hysterics	attack
salvation	rescue
forced	compel
suffering	pain
invest	spend
cadavers	body
project	work
exclamation	utterance
conquers	control
wrinkles	depression
downsizing	economy
whacking	corporal_punishment
flashbacks	transition
paces	rate
abound	be
suitcase	baggage
adapts	change
beard	facial_hair
solutions	mixture
crank	unpleasant_person
felt	fabric
bears	carnivore
sucker	victim
nausea	symptom
assurance	certainty
monkeys	primate
psychiatrist	specialist
sucked	drink
misfire	breakdown
cooker	cooking_utensil
goggles	spectacles
paths	course
snickers	laugh
forces	influence
flying	air_travel
trimmed	cut
internet	computer_network
ranges	extent
half-hour	time_unit
talkers	articulator
knocks	sound
charmer	hypocrite
bitten	grip
slain	dead
beast	organism
resides	populate
bitter	ale
gesture	motion
urgency	necessity
freudian	follower
backstage	stage
activists	reformer
sidesteps	step
performances	show
prologue	introduction
organic	fertilizer
dwells	worry
paced	walk
overlook	topographic_point
beats	youth_subculture
bedroom	room
cello	bowed_stringed_instrument
prints	written_communication
money	medium_of_exchange
stakes	gamble
avalanche	slide
euphoria	elation
mob	crowd
ratchets	mechanical_device
madcap	adventurer
achievement	action
sunshine	light
mom	mother
whole	concept
sharks	elasmobranch
fingers	digit
revolution	change
admirers	advocate
movies	product
humor	message
obstacle	hindrance
transvestite	person
attempts	activity
profits	income
still	photograph
relating	think
linking	think
enriched	better
resemblance	likeness
mr.	title
photographed	record
anthology	collection
benchmark	standard
books	publication
knowing	higher_cognitive_process
hoofing	dancing
parallels	similarity
bawdy	obscenity
alluring	invite
rediscovers	discover
galvanize	shock
tongue	articulator
signature	name
churn	vessel
ms.	title
fireworks	low_explosive
punch	blow
throwing	propel
slave	person
decommissioned	recall
believes	content
believer	supporter
writing	verbal_creation
excursion	journey
believed	accept
academy	secondary_school
washout	groove
shtick	small_indefinite_quantity
bygone	past
gusto	enjoyment
swallow	taste
aged	age_group
genocide	killing
sting	pain
households	unit
sends	move
stink	smell
altogether	nakedness
alexander	herb
gored	pierce
sleeve	cloth_covering
apocalypse	calamity
cutting	creating_by_removal
dulled	change
ages	property
dimensions	magnitude
specifics	fact
voice	sound
morsels	small_indefinite_quantity
injuries	ill_health
prepared	change
fertility	rate
rekindles	kindle
craft	occupation
float	time_interval
juxtaposition	placement
parables	story
frittered	consume
budding	asexual_reproduction
disarming	demobilization
evade	avoid
uncertainties	quality
expecting	evaluate
discover	spy
imply	express
offset	point
extremists	radical
parlor	reception_room
cascade	waterfall
cleaner	formulation
mysteries	perplexity
capture	acquiring
excite	arouse
paranoia	psychosis
sounding	depth
slaps	blow
literate	person
baloney	nonsense
paranoid	psychotic
appointed	establish
sequence	series
sulky	horse-drawn_vehicle
mud	soil
mug	containerful
youngsters	juvenile
elder	adult
lip-gloss	makeup
commonplace	remark
touts	scalper
caterer	supplier
prescribed	inflict
blubber	animal_oil
crudities	wild
talks	discussion
iteration	process
austrian	european
distances	spacing
encompassing	include
grinder	sandwich
controversy	dispute
jack	small_indefinite_quantity
command	speech_act
irritates	displease
enthronement	initiation
distanced	keep
grimace	facial_expression
chump	victim
variable	thing
temple	place_of_worship
jabs	gesture
greaseballs	italian
matron	wife
perfection	state
landscape	scenery
saved	rescue
desperate	unfortunate
leading	strip
firebrand	firewood
urge	motivation
endings	morpheme
music	auditory_communication
saves	prevention
screenings	display
famine	lack
educate	better
ricocheting	jump
springer	stone
agreement	statement
dealing	treatment
ensues	prove
intermezzo	movement
wanes	decline
merchant	businessperson
pegged	succeed
capitalize	profit
overload	load
bronze	copper-base_alloy
contains	include
permits	legal_document
selection	action
guess	opinion
science	discipline
conception	idea
protracted	lengthen
returns	legal_document
happening	event
guest	visitor
detail	fact
flailing	beat
beware	watch
forest	vegetation
stretches	expanse
elevates	delegate
fantasies	imagination
scratches	wound
weiss	dynasty
debated	consider
matrix	array
backwater	body_of_water
vigils	wakefulness
sleep	physical_condition
stretched	be
refuse	waste
crumb	small_indefinite_quantity
sleek	polish
sonny	male_child
elevated	railway
oeuvre	end_product
certified	testify
behavior	activity
intimidated	frighten
toes	digit
enthralling	please
sweep	scope
flimsy	typewriter_paper
descend	travel
website	computer
bromides	halide
flavour	atmosphere
evenings	day
highlighted	bring_out
superlative	praise
mechanics	physics
pushing	propulsion
wanker	masturbator
weird	anglo-saxon_deity
farce	comedy
redone	produce
upside	side
emerge	appear
exemplify	embody
slap	blow
anniversary	day
decorates	change
incorporates	compound
screening	display
deliverance	recovery
eager	tidal_flow
republic	political_system
emphasising	stress
melancholic	depressive
jerking	motion
repetition	periodic_event
melancholia	depression
whirlwind	windstorm
huggers	person
enlivens	stimulate
overheated	heat
layers	artifact
female	animal
digressions	message
surrender	despair
hypnotic	drug
poised	hover
wrote	create_verbally
modeled	imitate
intentions	goal
bores	unpleasant_person
evergreen	vascular_plant
obviousness	conspicuousness
volume	measure
energies	physical_phenomenon
casts	gathering
conditioning	learning
oozing	flow
outsiders	stranger
rises	emergence
whodunit	story
becalmed	stabilize
punches	blow
chimney	flue
technical	military_vehicle
baggage	case
respecting	see
breakdown	disruption
ride	journey
veneer	coating
inconsistencies	contradictoriness
punched	hit
defies	resist
stretch	expanse
plummets	bob
spirited	enliven
havoc	disturbance
capitalism	market_economy
dating	chemical_analysis
fifties	decade
photographer	artist
showcases	setting
dumped	discard
illuminate	lighten
selecting	decide
delirium	mania
mistake	nonaccomplishment
nauseating	disgust
rich	people
enthrall	please
rick	spasm
moldering	decay
scouse	stew
rice	grain
praise	approval
frenzy	mania
significance	importance
cutthroat	murderer
weirdness	unfamiliarity
sweat	secretion
family	unit
vanessa	arthropod_genus
deliberate	hash_out
swear	express
slew	large_indefinite_quantity
referred	think_of
atmosphere	condition
gift	acquisition
winking	reflex
career	occupation
told	express
release	merchandise
glosses	explanation
slim	change_state
abiding	stay
rolled	turn
crosses	racket
marveled	react
moral	meaning
hallmarks	characteristic
judge	adjudicator
tackles	lineman
darkness	illumination
mid-seventies	time_of_life
permeates	penetrate
partnership	business
aliens	traveler
lionize	respect
parrots	bird
tackled	confront
negativity	polarity
thousands	large_integer
jams	conserve
wives	spouse
cylinders	solid
weathered	defy
relevance	connection
driver	operator
flawed	damage
drives	propulsion
driven	operate
lovebirds	parakeet
crossed	pass
carved	cut
roller	grounder
drivel	message
souvlaki	kabob
tone	manner_of_speaking
optimism	hope
fiascos	collapse
savor	taste
fetishes	sexual_desire
holiday	leisure
crude	fossil_fuel
in-jokes	joke
withstand	resist
encourage	support
morality	quality
potato	root_vegetable
manufactured	make
deficit	insufficiency
uphill	ascent
busts	failure
pissed	excrete
linger	persist
tome	book
stores	mercantile_establishment
grandmother	grandparent
aesthetics	philosophy
touchstone	system_of_measurement
locales	scene
slip	blunder
anchor	hook
firing	attack
logic	philosophy
manifesto	declaration
novelist	writer
homages	deference
capped	lie
telegraphed	telecommunicate
honor	symbol
tops	region
eccentrics	anomaly
mores	convention
scorcher	hot_weather
losses	financial_loss
aerial	pass
dimness	semidarkness
languishing	weaken
admiring	respect
whites	person
pages	leaf
scalds	burn
squirming	move
weaned	deprive
net	computer_network
laggard	idler
cable	telegram
conceptions	idea
took	act
catching	playing
settings	environment
smarts	pain
barker	promoter
shootout	fight
parody	caricature
bluster	confusion
rumination	consideration
moralism	maxim
tool	implement
steeped	concentrate
vulgarities	inelegance
underestimated	value
stimulating	affect
tons	large_indefinite_quantity
bestowed	award
heated	change
torn	separate
enigma	perplexity
tori	round_shape
barrage	language
slog	work
influenced	affect
meander	curve
befallen	happen
reaching	motion
media	instrumentality
slot	position
seeping	run
lightweight	prizefighter
slop	feed
influences	power
define	be
dictate	rule
slob	vulgarian
cinderella	woman
deliberateness	pace
stepped	travel
coating	covering
prelude	origin
air-conditioning	process
fatherhood	kinship
employment	state
korean	asian
specific	fact
super	caretaker
starship	spacecraft
risks	danger
engage	act
windtalkers	secret_agent
muttering	sound
territory	region
milked	draw
u.s.	federal_government
developments	improvement
collage	paste-up
oddity	eccentricity
ring	sound
shift	translation
cultist	follower
entertainments	diversion
frolic	diversion
gestalt	form
tots	small_indefinite_quantity
professional	adult
cheese	dairy_product
bilked	cheat
lanes	way
builds	bodily_property
butler	manservant
shoulder	body_part
dance	art
farts	reflex
pearl	jewel
models	hypothesis
flinch	startle
ensuing	prove
iota	small_indefinite_quantity
forgiveness	mercifulness
exchanges	chemical_phenomenon
amaze	surprise
softens	change_intensity
toss	throw
derisions	disrespect
mystery	perplexity
slow	decrease
blips	shock
patched	join
graduated	receive
myrtle	periwinkle
deserved	be
recount	count
updatings	change
flash	happening
associations	organization
complexity	quality
mosque	place_of_worship
bucks	horse
amuses	entertain
regrets	acknowledgment
students	enrollee
recommend	propose
literal	error
leniency	mercifulness
amused	entertain
advertisement	promotion
disabled	people
expectations	belief
hooks	hand
departs	exit
lothario	womanizer
brooms	cleaning_implement
stalker	pedestrian
silly	child
quicksand	situation
ghetto	quarter
suffocate	kill
quibbles	evasion
bliss	elation
riot	violence
tout	scalper
tour	journey
boring	creating_by_removal
shatters	burst
stayed	be
absolute	abstraction
quintet	musical_composition
wrestler	combatant
gossip	chat
fabian	socialist
resulted	prove
showgirls	dancer
documents	writing
jazz	talk
swung	move
mystification	confusion
abridged	decrease
underlay	pad
no.	number
strips	part
research	investigation
dwarfs	small_person
blackout	pause
royals	sail
sophomore	lowerclassman
stalked	walk
segment	part
stripe	adornment
houses	building
retaining	hold
marshaled	put
gourd	bottle
wounds	injury
imagine	create_by_mental_act
town	municipality
penance	compunction
engineering	application
boats	vessel
girl	woman
denizens	person
filmmaker	producer
engrossing	concentrate
razzle-dazzle	play
ugliness	appearance
overcooked	cook
swinging	motion
trifle	pudding
wartime	time_period
involving	refer
aspires	plan
crocodile	crocodilian_reptile
blind	people
nod	gesture
string	cord
color	visual_property
affluent	rich_person
indigestion	symptom
patting	caress
simplicity	quality
lipstick	makeup
grooved	incise
drops	sphere
aspired	plan
intrigued	matter_to
blimp	reactionary
now	present
tempered	harden
glorified	praise
statement	message
lived	be
rite	religious_ceremony
headaches	negative_stimulus
thoughts	content
delivery	transportation
election	vote
toys	artifact
breaks	happening
conquer	control
unifying	integrate
continuity	coherence
detailed	elaborate
putters	golfer
slurs	musical_notation
battles	military_action
risk	danger
delivers	talk
flame	combustion
rise	emergence
gunplay	fight
sorcerer	occultist
recalls	request
innocence	naivete
butterflies	lepidopterous_insect
flair	endowment
exiled	expel
crush	leather
hatred	emotion
conflagration	fire
endured	permit
struggling	try
catch	drawback
nourishing	provide
promising	declare
give	elasticity
enchanting	please
liven	stimulate
ahem	utterance
idealism	philosophical_doctrine
guises	semblance
lives	being
depends	be
midsection	area
imbue	penetrate
metro	railway
get-go	point
ladies	woman
hoods	criminal
gimmicks	drawback
apartments	housing
bastard	unpleasant_person
villains	unwelcome_person
purity	condition
flags	emblem
direct	order
scheming	plot
slanted	lie
hardship	misfortune
confuse	mistake
acumen	plant_process
modern	person
acknowledging	declare
probes	inquiry
enables	change
transmogrification	transformation
patrolmen	lawman
dishes	container
wrong	injustice
bourne	boundary
porridge	dish
shirt	garment
enchanted	please
songs	musical_composition
whet	stimulate
hampered	restrict
stockings	hosiery
creepiness	touch
yarns	report
heads	external_body_part
levels	property
board	committee
cross-dressing	dress
distorts	misrepresent
pulpiness	softness
pursuing	act
widow	woman
springing	move
spelled	recite
schizophrenia	psychosis
whit	small_indefinite_quantity
whir	sound
whip	instrument
halloween	day
earned	get
whale	large_person
sturdiness	good_health
letting	property
robots	mechanism
rhetoric	expressive_style
marked	attach
respite	relief
intrigue	plot
handicap	unfitness
survival	animation
hysteria	mania
pleasing	gratification
market	activity
keen	dirge
effects	personal_property
keel	projection
refers	think_of
marker	artifact
keep	resource
crassness	insensitivity
conventions	meeting
eagle	bird_of_prey
staggers	animal_disease
acute	accent
matinee	theatrical_performance
relocated	move
sentimentalizing	misrepresent
deserves	be
dehumanizing	take_down
endurance	strength
confessions	admission
swings	action
relaxed	change_state
succumbs	accept
rocks	natural_object
inversion	atmospheric_phenomenon
parallel	similarity
dialogue	talk
blunder	mistake
designed	create_by_mental_act
breach	failure
handful	small_indefinite_quantity
pinks	chromatic_color
stimulus	information
curmudgeon	oldster
hackles	anger
approaches	conceptualization
terminal	station
fritters	friedcake
adhering	match
shine	brightness
ballast	material
critics	professional
contained	include
disjointed	separate
uses	activity
propels	move
approached	come
succumb	accept
essayist	writer
fussing	worry
unfold	develop
inhabitants	person
diminishing	change_magnitude
humanist	scholar
dipped	immerse
bring	transport
humanism	doctrine
brink	boundary
aversion	dislike
musketeer	infantryman
warfare	military_action
escapist	daydreamer
giant	animal
perch	support
promotes	support
escapism	diversion
vein	blood_vessel
veil	garment
league	association
hierarchy	series
islanders	inhabitant
machismo	masculinity
boiling	heating
puppy	dog
turning	change_of_course
peace	order
malapropisms	misstatement
garnered	get
consideration	thinking
brother	male_sibling
frank	european
1930s	decade
viability	property
teetering	move
claws	horny_structure
search	activity
communications	discipline
metaphor	trope
deranged	madden
televised	air
franc	monetary_unit
gluing	attach
cardboard	packing_material
shambles	disorderliness
topping	garnish
humanity	humaneness
soliloquies	speech
innovation	creation
lurking	hide
wedgie	shoe
couture	dressmaking
alternate	stand-in
mounted	attach
actor	performer
deleted	remove
zipper	fastener
superstar	expert
fueled	supply
sewage	waste
essential	thing
conveyor	messenger
vent	hole
clarify	explain
lightness	joy
girls	woman
graphics	visual_communication
recompense	payment
thinness	dimension
fighters	person
generosity	kindness
bohemian	indian
japanese	asian
presumes	expect
warning	informing
troopers	soldier
evoked	make
image	representation
cameos	anaglyph
portray	represent
mainland	land
celebration	affair
condone	forgive
temptation	influence
evokes	make
manhood	adulthood
carry	transportation
burst	change_of_integrity
commenting	note
necessity	need
frame	framework
indie	pop_group
mountains	natural_elevation
snapping	talk
compelling	induce
origin	point
clash	noise
mistakes	nonaccomplishment
dozing	nap
antic	diversion
pimps	wrongdoer
mistaken	identify
layered	shape
burden	concern
overture	music
personality	attribute
artificiality	unnaturalness
teachers	educator
doppelganger	legendary_creature
trouble	difficulty
class	collection
reporting	news
inuit	indian
spanish	romance
kidnappings	capture
brims	edge
gamble	speculation
counter	table
hairdo	hair
cheapened	worsen
drifts	force
signposts	sign
presents	time
assign	appoint
promotion	message
drab	olive
decade	time_period
practice	activity
quaking	tremble
weaponry	instrumentality
backdrops	scenery
canadian	north_american
diaries	writing
delayed	decelerate
amusements	delight
groundbreaking	beginning
enveloping	cover
lunatic	sick_person
carol	religious_song
astronaut	traveler
agony	suffering
marveling	react
drag	resistance
clams	money
guessing	estimate
french	romance
swooning	zonk_out
burnt	destroy
encouraging	support
issue	content
lower	berth
commercials	ad
metal	chemical_element
peaks	limit
ode	lyric
legion	army
dictates	rule
cheeks	feature
vintage	wine
drinker	consumer
humanize	change
continuing	act
brooding	parturition
pedestal	support
immaturity	state
turned	move
widen	increase
vaunted	overstate
gibberish	nonsense
library	room
strings	section
slump	deterioration
digest	periodical
peril	danger
dependence	state
standbys	thing
camera	photographic_equipment
modernize	regenerate
broaches	pin
remembrance	memory
seemed	be
fumbles	blunder
draw	gully
contender	contestant
off	kill
disabilities	unfitness
exploring	investigate
overlapping	covering
seriousness	gravity
fumbled	search
oral	examination
tipped	reorient
complete	end
compensate	balance
personified	embody
mattered	be
domination	social_control
coupling	connection
edge	boundary
weaving	handicraft
willies	edginess
strongman	performer
claim	assertion
credibility	quality
antique	old_man
jarring	conflict
hobbled	walk
months	time_period
meter	metric_linear_unit
follows	travel
retold	re-create
schematic	diagram
chosen	darling
puff	gust
coat	overgarment
fidgeted	move
expand	grow
squander	use
coal	fossil_fuel
retrieve	get
devastating	destroy
bride	newlywed
gliding	flight
furrow	trench
code	written_communication
hammer	striker
implodes	collapse
blab	unwrap
coda	conclusion
incompetent	unskilled_person
harangues	declamation
underdeveloped	develop
investigate	analyze
devastation	deterioration
investigator	scientist
mutates	change
dreamed	imagine
recreating	stimulate
sympathy	inclination
fight	military_action
blah	grandiosity
brief	legal_document
cavorting	play
romped	play
cringing	move
betting	predict
surfeit	fullness
painting	graphic_art
pandemonium	confusion
ploughing	tilling
spiritual	religious_song
remarks	statement
bracing	strengthener
honks	cry
regeneration	organic_process
indoctrinated	teach
mopes	low_spirits
promised	declare
calculus	rock
relayed	communicate
speaking	utterance
exercises	effort
province	administrative_district
agitator	troublemaker
whopping	hit
shifts	translation
obscenity	indecency
promises	commitment
breaking	change_of_integrity
proposal	message
orgy	indulgence
conspirators	criminal
edit	change
old	past
settled	put
lowered	move
recreation	activity
spectators	perceiver
ancient	oldster
twelve	large_integer
starting	turn
device	instrumentality
minus	arithmetic_operation
checking	analyze
conservative	adult
archives	collection
activity	act
bled	exhaust
entranced	attract
waltz	victory
fresher	lowerclassman
bleu	cheese
variety	collection
disturb	affect
tanks	armored_vehicle
liar	deceiver
paved	coat
pump	mechanical_device
strained	tug
disconnection	separation
numbness	symptom
linearity	dimensionality
fights	military_action
one	digit
garage	outbuilding
whirling	rotation
shudder	fear
reviewers	critic
flashbulbs	lamp
pull	propulsion
dealer	merchant
buying	purchase
threatens	exist
prefabricated	produce
urinates	excrete
pulp	mass
undergraduate	collegian
makeup	cosmetic
country	political_unit
excellence	quality
urine	body_waste
willing	choice
marathons	undertaking
sincerity	gravity
demons	evil_spirit
fatalism	credence
elicit	make
amazing	surprise
awareness	knowing
postcard	card
lick	sediment
longevity	longness
trimming	decoration
details	information
aids	immunodeficiency
futility	inutility
sentimentality	emotionality
treated	interact
smiling	facial_expression
emotions	feeling
reefs	ridge
accentuating	express
suppose	speculate
flavor	atmosphere
clocked	quantify
shimmering	shine
obscure	hide
explodes	change_integrity
punk	criminal
trove	treasure
region	location
support	activity
exasperating	anger
praises	approval
flibbertigibbet	fool
puns	fun
drop	sphere
disassociation	separation
hindsight	understanding
pulsating	beat
shaped	cause
destination	end
learning	basic_cognitive_process
cold	communicable_disease
resolutions	document
vertical	orientation
eccentricities	unfamiliarity
life	being
expects	evaluate
punctuated	add
shapes	spatial_property
filmmakers	producer
settles	bench
lies	falsehood
tango	ballroom_dancing
spells	psychological_state
blip	shock
cases	happening
clobbering	beat
ditty	song
unpleasantness	pain
coke	fuel
damn	worthlessness
superior	leader
location	object
proportions	quotient
sentimentalist	person
populist	advocate
revel	merrymaking
surrounds	geographical_area
stains	appearance
eclair	cream_puff
woven	twist
competition	business_relation
zany	clown
none	hour
displays	demonstration
cone	artifact
reeks	smell
therapeutic	medicine
problem	difficulty
closing	motion
melodrama	comedy
depressed	discourage
connection	relation
abandoned	discard
presence	being
cons	argument
inability	cognition
obsessed	preoccupy
method	know-how
makers	creator
wife	spouse
come	liquid_body_substance
leather	animal_skin
push	propulsion
coma	unconsciousness
musicals	movie
o.k.	sanction
purr	sound
examples	information
ascension	holy_day_of_obligation
johnny	confederate_soldier
lift	aid
insiders	corporate_executive
cops	policeman
yiddish	german
misdemeanor	crime
conceived	create_by_mental_act
goths	unpleasant_person
mending	garment
busby	hat
out	failure
cope	brick
capacity	capability
consuming	eat
ghost	apparition
noon	hour
transcript	writing
hoopla	promotion
troubadour	singer
dark	illumination
disconnects	disparity
copy	written_record
dare	challenge
streaks	succession
danish	scandinavian
introverted	draw_in
cook	skilled_worker
cool	coldness
elbows	hinge_joint
regurgitates	pour
infuse	drill
purists	pedant
puts	option
emaciated	enfeeble
connoisseurs	authority
seaside	seashore
structuring	organize
unified	integrate
matured	develop
asset	quality
insecurity	danger
insulting	hurt
revolutionaries	radical
minimum	extremum
roses	shrub
coos	cry
date	day
magic	supernaturalism
reveal	show
corn	cereal
grinning	facial_expression
drum	percussion_instrument
drug	agent
norm	standard
successes	happening
daydreams	dream
argentine	soft-finned_fish
consequences	phenomenon
simmer	temperature
blow	stroke
gambles	speculation
climbing	rise
development	improvement
like	kind
maxim	saying
smorgasbord	collection
proposes	declare
populated	be
brisk	accelerate
prolonged	lengthen
plutonium	chemical_element
spontaneity	naturalness
activism	policy
ending	morpheme
core	set
efforts	activity
dass	placental
blob	amorphous_shape
dazzling	blind
flopping	collapse
hills	natural_elevation
ground	object
dreadfulness	unpleasantness
dash	elegance
visitor	traveler
branched	grow
sprawl	urban_area
note	written_record
brits	nation
moonlight	light
make-believe	imagination
line	formation
penalty	social_control
link	linkage
riding	sport
toss-up	luck
recovery	improvement
trappings	accessory
implosion	collapse
robin	thrush
limp	gait
hearts	whist
treacle	syrup
populates	be
regimen	plan
considers	think
nose	chemoreceptor
limb	extremity
aims	goal
cost	outgo
stories	message
will	faculty
embalmed	conserve
confidence	certainty
groups	abstraction
cuisine	cooking
rediscovering	discover
loopholes	ambiguity
lilo	air_mattress
bordering	touch
york	dynasty
narration	message
lily	liliaceous_plant
dignity	pride
challenge	situation
locations	object
unearth	locate
wild	state
satyr	pervert
plagued	afflict
snap	touch
slowed	decrease
functions	mathematical_relation
wastes	material
chips	potato
overflowing	spill
forages	fodder
waster	prodigal
anchored	fasten
remote	device
palestinians	arab
explanation	statement
cafeteria	restaurant
assassin	murderer
drumbeat	sound
rider	traveler
pummel	hit
yearnings	desire
spoofs	caricature
contributions	attempt
victor	combatant
framed	enclose
graduation	completion
wasted	use
undressed	take_off
prison	correctional_institution
sister	female_sibling
yesteryear	time
whimsy	idea
wins	victory
everlasting	composite
frames	framework
devices	inclination
dedication	fidelity
perpetrating	act
neutral	person
thoughtfulness	consideration
baker	merchant
analysis	investigation
costumer	couturier
costumes	attire
rewrite	writing
revives	bring_to
lion	big_cat
journalism	print_media
journalist	writer
lint	fiber
exposure	vulnerability
clutch	grasping
baked	cook
seizing	small_stuff
morphs	change
asparagus	herb
enlightened	people
dawn	hour
costumed	dress
wing	organ
cribbed	cheat
wind	weather
revived	bring_to
humble	change
folly	trait
flight	formation
harbour	port
independent	individualist
airs	affectedness
glossy	magazine
achieve	succeed
yellow	chromatic_color
blur	representation
embroils	involve
talking	conversation
alleged	assert
diversions	activity
squareness	rectangularity
sexism	discrimination
gang-raped	rape
lameness	disability_of_walking
sexist	antifeminist
editorial	article
sharper	card_player
cows	bovine
combines	harvester
faced	set_about
echoes	reflection
americans	inhabitant
lips	articulator
overwhelm	arouse
blue	chromatic_color
reunions	party
speaks	communicate
concludes	think
days	life
persistence	lastingness
governs	decide
combined	have
disguise	semblance
faces	external_body_part
facet	feature
tedium	dissatisfaction
saddens	affect
undone	change_by_reversal
liberal	adult
discuss	field_event
renders	stucco
1940s	decade
chill	coldness
trivializing	understate
wish	desire
miami	algonquian
invigorating	stimulate
pad	paper
pastel	chromatic_color
wise	manner
toddler	child
amounts	assets
pandering	provide
payback	return
wisp	tuft
reparations	compensation
pal	friend
skipping	neglect
pan	cooking_utensil
sparring	controversy
weighted	charge
conversation	speech
pap	drivel
par	score
pat	sound
recycles	cycle
invitation	letter
pax	greeting
pay	regular_payment
memento	reminder
crackers	bread
list	database
bellyaching	complain
rivals	contestant
ventures	undertaking
sixties	decade
wire	ligament
spending	payment
sobering	change
scenes	area
claims	assertion
folks	kin
preserving	keep
permitting	accept
creature	organism
child	juvenile
pbs	buffer_solution
straddle	position
unnerving	upset
divided	change_integrity
deploys	position
instrument	device
latches	lock
wonderment	astonishment
medium	instrumentality
locale	scene
fingering	placement
remove	distance
wisdom	content
recycled	cycle
producing	make
peas	legume
psychology	science
wannabe	applicant
interrogation	sentence
fogging	hide
treasure	wealth
monologues	speech
live	be
maneuvers	operation
espoused	choose
dispossessed	deprive
codswallop	drivel
insults	disrespect
peak	limit
shrugging	gesticulate
libertine	bad_person
crematorium	morgue
taiwanese	asian
service	work
there	location
coffee	beverage
sharpie	actor
veggies	produce
strands	form
thunderstorms	storm
tumbleweeds	weed
american	inhabitant
porno	creation
affords	spend
pee	body_waste
uncles	kinsman
heroes	leader
portrayed	represent
pen	writing_implement
redefinition	definition
pep	liveliness
skunk	unpleasant_person
scripted	write
pet	animal
oscar	award
period	fundamental_quantity
proceed	talk
infants	child
encumbers	restrict
spears	weapon
even	day
penned	create_verbally
superficiality	depth
meetings	gathering
indication	communication
intelligibility	comprehensibility
engaged	act
assumes	expect
integrating	group_action
folds	angular_shape
vulgarity	inelegance
kinds	category
disgusted	stimulate
engages	act
prevalence	generality
peep	cry
tainted	mar
liza	mullet
provocateur	secret_agent
entree	course
wrenching	pull
violence	aggression
monday	weekday
bought	get
impressions	idea
gamut	scope
decibel	sound_unit
peek	look
verge	boundary
hang-ups	preoccupation
pastry	dough
milieu	environment
charred	burn
misdirected	change
tensions	strain
retains	hold
charade	caricature
imposed	compel
environments	situation
arrow	mark
reign	time_period
appropriated	assign
manner	property
penetrating	enter
pic	product
pie	pastry
pig	swine
perils	danger
judgment	opinion
pin	jewelry
reaffirming	affirm
rowdy	attacker
members	associate
pit	hole
stock	capital
goofball	fool
guarantees	assurance
suspend	hang
overkill	capability
terror	fear
camouflaging	disguise
surge	flow
heroic	epic_poem
italics	longhand
instilled	lend
guaranteed	pledge
overdoing	make
belittle	disparage
chick	chicken
girlfriend	friend
privates	reproductive_organ
snow	precipitation
cloaks	covering
agape	love
evil	transgression
spooks	unpleasant_person
juxtapositions	placement
rising	change_of_location
fruit	reproductive_structure
prisoner	unfortunate
weasels	person
cause	origin
represents	equal
parlance	formulation
playlist	list
design	creating_by_mental_acts
attending	basic_cognitive_process
working	excavation
friday	weekday
explanations	statement
kindred	social_group
victim	unfortunate
conformity	agreement
department	division
xmas	feast_day
buttons	fastener
chief	leader
liberties	independence
aircraft	craft
ouija	board
darned	repair
satisfying	meet
italian	european
despite	dislike
followed	travel
euphemism	saying
gunfire	shooting
burning	change_of_integrity
groan	utterance
labours	class
treading	travel
reunion	party
distaste	dislike
submerging	sinking
interested	arouse
machines	device
credited	impute
accessibility	convenience
apparatus	equipment
teenagers	juvenile
retreats	withdrawal
rollerblades	in-line_skate
clashing	hit
recycle	cycle
claustrophobia	simple_phobia
meeting	gathering
portions	relation
byways	road
bible	sacred_text
anthropology	social_science
tuning	calibration
roiling	move
recognize	accept
binging	eat
processor	business
figuring	problem_solving
marina	dock
humming	noise
comparisons	examination
reality	experience
brutality	cruelty
offend	anger
demonstration	show
coaster	resident
rover	traveler
actions	act
anomaly	abnormality
indicative	mood
realism	practicality
scrutiny	investigation
giving	sharing
facts	information
marine	serviceman
pent	create_verbally
pop	father
routine	procedure
excuse	defense
pot	cooking_utensil
mornings	time_period
coolness	calmness
pow	prisoner
demonstrating	show
escape	running_away
gives	elasticity
funny	joke
emerging	appear
latest	news
equate	study
receive	get
suckers	victim
surplus	overabundance
decadent	bad_person
shaping	process
standing	status
ceremonies	affair
dabbles	dunk
startling	shock
hailed	applaud
implies	express
feelings	sensitivity
blemishes	appearance
slides	plate_glass
friendship	relationship
portrayal	word_picture
subsided	weaken
placing	move
intoxication	physical_condition
dramatization	writing
digested	process
disappointed	thwart
mediocrity	ordinariness
continue	act
attracts	pull
realize	know
offers	speech_act
given	assumption
crimes	transgression
pro	athlete
secrets	information
casualties	victim
exaggerated	misinform
playing	musical_performance
quibble	evasion
asking	speech_act
sinks	plumbing_fixture
hooked	fasten
surroundings	environment
rustic	commoner
documenting	record
lip-reading	read
hibiscus	mallow
extrusion	projection
assembled	join
overview	summary
chanukah	jewish_holy_day
assembles	join
attentions	basic_cognitive_process
volatile	substance
dashing	rush
grumbling	noise
windows	operating_system
generic	wine
genius	intellectual
curves	line
orgasm	consummation
freewheeling	exist
pub	tavern
bravery	spirit
forming	make
pug	dog
skeletons	minimum
shadow	shade
striving	attempt
pun	fun
assassination	defamation
circles	ellipse
extracting	remove
program	idea
wrists	gliding_joint
scrapbook	album
put	option
snared	capture
options	derivative_instrument
gangs	association
trap	device
tarzan	man
struggle	attempt
grows	change
reassuring	calm
meets	athletic_contest
unfolds	develop
infamy	dishonor
missteps	blunder
conclusions	judgment
heritage	practice
bruising	injure
junior	upstart
light	actinic_radiation
inanities	meaninglessness
valuable	treasure
muddle	disorderliness
stifling	prevention
mired	involve
artist	creator
questioning	request
indictment	legal_document
overshadows	brood
riveted	think
intoxicating	stimulate
profanities	utterance
elite	upper_class
ivory	dentine
minimalist	conservative
sloughs	pathology
theme	message
grown	change
burlap	sacking
flashbulb	lamp
clicking	move
barrel	tube
predators	attacker
serviceability	utility
desire	feeling
suffers	experience
classics	literary_study
touching	contact
muddy	dirty
disgrace	dishonor
smeared	dirty
wonderland	land
january	gregorian_calendar_month
backgrounds	inheritance
preciseness	clarity
organized	make
travel	motion
choice	decision_making
defeated	people
civilization	society
trey	digit
replace	regenerate
ramblings	continue
stomach	internal_organ
transitions	change_of_state
listen	perceive
wondering	question
hitman	murderer
trek	journey
major	commissioned_military_officer
answering	state
epilogue	conclusion
employs	state
compels	induce
consider	think
flatter	praise
group	abstraction
actuary	calculator
grubbing	obtain
gross	large_integer
shoestring	lace
workshop	workplace
acclaimed	applaud
tree	woody_plant
tact	consideration
archive	depository
eclipse	interruption
hurts	ill_health
epiphanies	manifestation
soar	rise
managing	succeed
sustain	continue
flagging	collection
soap	cleansing_agent
novels	fiction
induces	generate
nadir	adversity
classify	categorize
jokester	comedian
composure	disposition
reverberates	sound
self-examination	contemplation
thirteen	large_integer
banking	finance
general	general_officer
september	gregorian_calendar_month
caved	hollow
frighten	stimulate
confessional	booth
meandering	travel
delves	excavation
nostalgia	longing
padding	artifact
eternity	time
process	activity
unease	discomfort
clear	innocence
eighth	rank
craven	coward
substituting	work
confining	control
encounter	fight
clean	weightlift
marking	symbol
fluxing	move
fulfilling	complete
schtick	small_indefinite_quantity
outweighs	surpass
hurry	urgency
account	record
ticking	sound
innocent	person
sentimentalized	misrepresent
repulse	rejection
videos	visual_communication
hangover	discomfort
stabbing	injure
trio	digit
trip	journey
disintegrates	change_integrity
trim	neatness
hunting	blood_sport
rally	gathering
knowledge	psychological_feature
jump	increase
prime	number
iris	iridaceous_plant
intellect	intelligence
prima	eating_apple
festival	time_period
amble	walk
concubine	mistress
mainstream	thought
sparked	initiate
venture	undertaking
population	people
enthusiasm	feeling
route	line
propensity	inclination
triviality	unimportance
trying	act
appetizer	course
brushes	vegetation
millions	large_integer
simpering	smile
populating	be
comes	liquid_body_substance
soil	dirtiness
trusting	believe
smokers	consumer
varmints	bad_person
capability	ability
maggots	grub
involvement	group_action
haunts	area
spark	flash
hearing	proceeding
wedding	ceremony
embedded	insert
spare	component
boldface	font
spreads	change_of_location
drains	emptying
tail	process
stepmother	stepparent
transition	change_of_state
appeals	request
traps	device
june	gregorian_calendar_month
glee	gaiety
series	ordering
denuded	clear
junk	rubbish
phenomena	process
represent	equal
goodwill	intangible
accountant	businessperson
wounding	damage
dramatize	write
hold	grasping
fabricated	make
reworks	work
tale	message
trail	path
chinese	sinitic
hustler	prostitute
bewildering	confuse
absurd	situation
modesty	decency
chainsaw	power_saw
prior	superior
underwear	undergarment
purgatory	situation
talk	conversation
good-naturedness	cheerfulness
tall	size
landmark	position
blowout	victory
train	public_transport
planet	celestial_body
italicized	print
swaggers	itinerant
creep	unpleasant_person
italicizes	print
slowness	unskillfulness
spall	fragment
revolting	rebel
contradictory	logical_relation
take	income
rosemary	herb
seams	joint
rigged	cheat
boasting	speech_act
plunging	penetrate
hinge	joint
subtlety	meaning
nonbelievers	nonreligious_person
interweaves	twist
blanks	character
session	conference
samurai	warrior
tang	spiciness
jokers	comedian
tidings	information
insouciance	cheerfulness
passes	accomplishment
trot	locomotion
passer	pedestrian
prostituted	sell
amalgam	alloy
passed	travel
reception	greeting
tank	armored_vehicle
1950s	decade
potter	craftsman
venezuelans	south_american
slickness	misrepresentation
respects	message
rediscover	discover
sole	bottom
spans	duration
winged	travel
midnight	hour
junkie	addict
patrolman	lawman
jury	body
holy	topographic_point
darling	lover
remembering	basic_cognitive_process
affects	feeling
solo	activity
lifts	aid
tracks	line
home	residence
insomnia	sleep_disorder
oscars	award
hole	opening
print	written_communication
winger	athlete
tame	change
material	substance
marching	walk
sensuality	sexual_desire
idiom	formulation
downhill	descent
explain	inform
herrings	saltwater_fish
arguing	dispute
taps	bugle_call
answers	statement
ordinances	rule
shedding	organic_process
hope	anticipation
norwegian	european
executive	administrator
stagecrafts	craft
hook	catch
sons	male_offspring
tape	strip
fathom	linear_unit
displacement	replacement
anticipated	evaluate
hoot	cry
prism	polyhedron
glazed	coat
song	musical_composition
python	boa
wizardry	creativity
ridicule	disrespect
globalizing	widen
classified	newspaper_ad
cream	elite
hood	criminal
operative	agent
lawmen	defender
heavy	actor
disbelief	doubt
detached	disconnect
culprit	wrongdoer
underground	revolutionary_group
pageants	representation
rollicking	play
dragons	mythical_monster
machinery	machine
clients	case
painted	create
weddings	ceremony
innovators	originator
condensed	liquefy
diver	explorer
summer	season
smirk	smile
exploits	accomplishment
nerves	psychological_state
brusqueness	discourtesy
creek	stream
member	associate
incidents	happening
tart	woman
creed	doctrine
grease	oil
follies	revue
implausibility	incredibility
health	wellbeing
attackers	wrongdoer
positive	adjective
favourite	rival
rental	property
agents	causal_agent
prospect	potential
titillating	itch
machine	device
refugee	exile
infidelity	quality
evening	day
return	legal_document
confuses	mistake
instance	happening
backlash	movement
eliminating	destroy
convoluted	flex
rehash	material
serve	tennis_stroke
iraqi	asian
seats	room
drown	cover
smile	facial_expression
confused	mistake
surrendering	yield
reviews	appraisal
fine	penalty
find	insight
host	adult
gullets	muscular_structure
wonton	dumpling
lapel	lap
progressed	develop
downs	feather
film	product
sort	category
folktales	narrative
fill	enough
experiences	education
hears	perceive
heart	intuition
wanders	travel
trash	waste
i.q.	ratio
caretakers	custodian
task	work
watercolor	painting
scientists	person
transit	surveying_instrument
progresses	development
true	alignment
flaws	imperfection
leaning	inclination
adolescent	juvenile
tactics	military_science
concoction	foodstuff
valley	natural_depression
position	point
petty	larceny
glow	good_health
laughter	utterance
sentiment	feeling
soup	dish
patent	document
plumbed	quantify
soul	spirit
forewarned	warn
stalking	hunt
groove	depression
phones	electronic_equipment
quivering	motion
appears	be
schoolboy	male_child
sour	cocktail
delete	remove
hour	time_unit
ambivalence	feeling
convolution	round_shape
troubled	affect
hothouse	greenhouse
heard	perceive
experienced	undergo
execution	corporal_punishment
falling	travel
grinds	learner
equation	mathematical_statement
sought	desire
writers	communicator
vowing	pledge
finn	european
heaps	large_indefinite_quantity
processed	affect
spawn	egg
painkillers	medicine
narrator	speaker
privy	room
complicate	change
pulling	propulsion
forbearing	refrain
tracts	geographical_area
writer	communicator
simplify	change
writes	create_verbally
fence	barrier
coming	motion
splashed	scatter
kidnapper	captor
scream	cry
slather	spread
edifying	teach
procession	origin
contribution	attempt
fire	happening
self-awareness	awareness
sticking	fasten
solidity	consistency
fashioned	make
distinguish	identify
uplift	rise
numbered	be
taxi	car
savvy	knowing
tiger	person
symptom	evidence
reaffirms	affirm
serbs	slav
funeral	ceremony
except	object
chastity	abstinence
psychotic	sick_person
thuds	sound
comics	cartoon
ironies	wit
fist	hand
extremities	external_body_part
outline	boundary
teaming	group
excess	overabundance
plants	building_complex
perspective	orientation
patronising	support
operating	direct
bullets	projectile
landscapes	scenery
dogma	religious_doctrine
people	group
prognosis	prediction
democracy	political_orientation
abandon	unrestraint
fish	aquatic_vertebrate
khan	ruler
alarming	frighten
gourmet	sensualist
cannon	artillery
obligations	social_control
reputation	honor
maids	domestic
inside	region
descriptions	statement
graveyard	site
genesis	beginning
leaves	plant_organ
jean	trouser
provincial	official
adjusting	change
five	digit
ethnography	anthropology
devotees	follower
profundity	wisdom
goers	migrant
dispatching	transport
tuxedo	formalwear
oodles	large_indefinite_quantity
collection	group
hijacks	crime
fits	bad_temper
hunger	drive
immediacy	directness
squad	army_unit
channels	transmission
guessed	expect
campaign	race
yawning	reflex
conflict	group_action
kills	termination
serials	broadcast
reasons	rational_motive
rough	site
imparting	transmission
begging	solicitation
father	parent
swept	move
update	news
derivative	calculation
purge	clearing
rouge	makeup
commerce	transaction
septuagenarian	oldster
towers	structure
surfaces	artifact
mastering	education
wants	poverty
definition	explanation
wonder	astonishment
moron	simpleton
summary	statement
has-been	oldster
answered	state
madness	insanity
indians	amerindian
emigre	migrant
vaporize	kill
pander	wrongdoer
employ	state
rohypnol	club_drug
masked	disguise
radiates	emit
fable	falsehood
makings	production
embodies	be
dances	art
price	value
games	activity
defensive	attitude
reminiscence	memory
dependent	recipient
parachutes	rescue_equipment
welcomes	acceptance
leagues	association
hints	suggestion
decorating	change
reduced	decrease
cherish	love
focusing	concentration
imagination	creativity
resistance	action
fascination	enchantment
welcomed	accept
enjoyment	pleasure
buffoons	fool
nursery	child
versions	interpretation
pride	feeling
betrayed	unwrap
morph	change
favorite	choice
narrated	inform
distress	pain
broadcast	message
civilized	polish
hoped	wish
vampires	evil_spirit
dramatics	extracurricular_activity
birds	vertebrate
substitute	equivalent
causes	origin
incarnations	personification
hopes	anticipation
reduces	decrease
sadists	pervert
collective	enterprise
event	psychological_feature
demonstrated	show
muted	soften
buddy	friend
establishes	open
witnesses	perceiver
established	open
witnessed	watch
finger	digit
sympathize	feel
agency	administrative_unit
spat	quarrel
inhabit	be
multitude	large_indefinite_quantity
caused	make
sweetness	taste
fascinating	matter_to
fizz	beverage
rattling	noise
genitals	reproductive_organ
agenda	plan
evolving	create_by_mental_act
holocaust	destruction
damaged	change
thump	sound
fumes	gas
afflicts	upset
poking	gesture
storytellers	speaker
span	duration
lawyers	professional
prefer	like
struggled	try
perceptiveness	sensibility
cliffhanger	contest
minority	social_group
space	attribute
heller	slovakian_monetary_unit
reference	remark
chamber	enclosure
struggles	attempt
debilitating	weaken
trivialize	understate
publicity	message
centering	concentration
spree	intemperance
deceptions	falsehood
swedish	scandinavian
dictums	declaration
demonstrates	show
arresting	seize
bottom	side
wisecracking	comment
commitment	seriousness
decoder	intellectual
published	produce
spade	playing_card
collision	contact
cliches	remark
intervention	engagement
publicist	communicator
thrilling	stimulate
solving	determination
tract	geographical_area
professionals	adult
frequent	support
distractions	confusion
interact	act
jell	solidify
statements	message
laughs	utterance
network	system
terrorist	radical
doodled	draw
empowerment	management
holding	possession
trace	small_indefinite_quantity
moments	point
public	people
validated	authorize
array	arrangement
terrorism	terror
beers	brew
clubs	baseball_team
barbershop	shop
track	line
provocations	aggression
constructed	make
trades	commerce
mouthpieces	aperture
resources	assets
sisters	female_sibling
retooling	reorganize
transports	instrumentality
performance	show
bloodbath	slaughter
trade	commerce
round	ammunition
serial	broadcast
shortness	length
ennui	dissatisfaction
comic	performer
aiming	position
horses	equine
siblings	relative
references	remark
springboard	board
kangaroo	marsupial
accuracy	quality
rhapsodizes	tell
overbearing	dominate
curtsy	gesture
soars	rise
building	structure
setting	environment
triangles	polygon
nationalist	national
score	evaluation
quota	number
percussion	music
scorn	dislike
nationalism	loyalty
tangents	straight_line
sorts	category
ran	travel_rapidly
ram	volatile_storage
tightrope	rope
rap	reproach
navigate	travel
rat	rodent
withered	decrease
raw	nakedness
ray	light
sideshow	incident
lighting	illumination
packages	collection
shaking	agitation
snore	noise
hurried	travel
promenade	ball
undercurrent	meaning
topple	descend
invaders	intruder
endure	permit
placement	position
poster	sign
hobby	pastime
aaa	aortic_aneurysm
ringing	sound
tomcats	domestic_cat
throat	tubular_cavity
essence	content
bedfellows	associate
swill	feed
dwindles	decrease
uncertainty	quality
robbed	steal
dollar	monetary_unit
mopping	scrub
newsreels	short_subject
rolling	sound
bombshell	entertainer
begrudge	desire
treatise	writing
aspect	feature
targeted	aim
hobnail	nail
departments	division
indulgence	indiscipline
mumbles	utterance
pathos	quality
abc	fundamentals
awarded	allocate
pulled	move
swims	water_sport
photo	representation
libretto	script
riffs	berber
reconciliation	cooperation
sling	highball
forefront	front
desperation	condition
spin	rotation
calling	occupation
qualities	attribute
shallow	body_of_water
frankness	honesty
routines	procedure
tourists	traveler
collateral	security_interest
register	written_record
couple	pair
ace	digit
offended	anger
saddle	seat
guffaw	laugh
demise	end
romanticism	idealism
betrayal	dishonesty
red	chromatic_color
act	legal_document
awakening	arousal
duck	anseriform_bird
shortage	insufficiency
finish	decorativeness
helped	support
gifts	acquisition
moustache	facial_hair
add	syndrome
dreaming	imagination
escapes	running_away
gesturing	communicate
westerners	inhabitant
nincompoop	simpleton
ado	commotion
girlfriends	friend
escaped	flee
barbarism	atrocity
middling	commodity
cresting	lie
ruins	devastation
cultures	society
exchange	chemical_phenomenon
parsec	astronomy_unit
agonizing	pain
heaped	give
smashing	breakage
trust	property
puddle	covering_material
recharged	load
riveting	think
crypt	burial_chamber
turntable	platform
nurtures	upbringing
morals	motivation
soldiers	enlisted_person
theatres	building
duds	clothing
dues	right
disturbing	affect
laser	optical_device
happiness	emotional_state
scope	extent
duel	fight
nurtured	encourage
courageousness	spirit
humiliation	shame
laptops	portable_computer
embrace	clasp
intersect	meet
label	description
message	communication
recorded	save
misogyny	hate
crap	fecal_matter
truth	fact
cram	stuff
moves	decision
feminism	doctrine
dude	man
age	property
feminist	reformer
shoulders	body_part
aesthetic	philosophical_doctrine
iranian	asian
movie	product
popcorn	corn
tendency	attitude
overlooked	miss
boorishness	discourtesy
ambiguities	saying
chronicles	record
faults	nonaccomplishment
years	time_of_life
fisher	skilled_worker
neurasthenic	sick_person
chateau	country_house
gestures	motion
disappointment	dissatisfaction
stuttering	talk
muscles	contractile_organ
backseat	inferiority
odds	likelihood
decline	decrease
rip	libertine
spoiler	campaigner
businesses	enterprise
storyteller	speaker
whistle	sound
guise	semblance
exit	opening
system	instrumentality
courtship	entreaty
trilogy	trio
hairs	body_covering
spot	point
animated	stimulate
presenting	show
reactionary	conservative
aid	resource
depleted	spend
repugnance	disgust
nada	relative_quantity
aim	goal
sophistication	enlightenment
uncle	kinsman
doubling	multiplication
air	gas
defuses	remove
retail	selling
crew	unit
motivations	psychological_feature
accommodate	meet
glows	good_health
protagonist	advocate
vacation	leisure
speak	communicate
outcome	ending
restroom	facility
tender	medium_of_exchange
blushing	discolor
squandering	waste
horrors	fear
jews	person
moat	trench
boat	vessel
soiree	party
reversal	change_of_state
blondes	person
impresses	seizure
sociopath	neurotic
meditation	contemplation
future	time
banter	repartee
spades	playing_card
moan	utterance
movement	change
signing	language
workings	mechanism
fledgling	novice
duke	peer
rating	appraisal
ridley	sea_turtle
body	natural_object
piecing	join
moodiness	ill_humor
mode	property
cage	enclosure
brains	neural_structure
aussie	inhabitant
closure	approach
twisting	falsification
bode	bespeak
imposter	deceiver
faulted	charge
barrels	large_indefinite_quantity
conducted	manage
percentages	proportion
adhere	match
expense	cost
strangers	intruder
alas	process
haranguing	address
contemporary	peer
slips	blunder
swipe	stroke
mock	derision
mendes	better
outing	journey
rob	steal
amp	current_unit
interfering	impede
canned	preserve
communicates	convey
energizes	affect
favour	approval
ron	west_chadic
weakness	imperfection
rom	memory
gloss	explanation
rot	decay
bogs	wetland
messiness	disorderliness
energized	affect
row	line
self-satisfaction	satisfaction
freaking	panic
undermine	disobey
guilt	condition
sucks	consumption
tunes	music
blossom	reproductive_structure
paperbacks	book
wheedling	enticement
tacks	bearing
suggested	declare
caring	love
singles	badminton
ladder	stairs
swirl	round_shape
tuned	adjust
ascends	travel
ninth	rank
punctuation	interruption
starring	have
consists	exist
dull	change
collapse	illness
vibe	air
potency	control
educates	better
thought	content
concession	contract
paraphrase	rewording
legend	story
dichotomy	classification
taste	sensation
gambling	diversion
drowning	cover
cleavage	state
naught	relative_quantity
altar	table
byplay	acting
flatulence	physical_condition
cake	block
roundelay	song
ape	primate
english	west_germanic
poverty	financial_condition
stalls	farm_building
tummy	belly
margin	boundary
devoted	use
broke	end
nail	horny_structure
perplexing	confuse
stuffs	substance
spirits	alcohol
males	animal
testament	creed
mount	horse
toilet	room
grade	gathering
lolita	lass
hodgepodge	assortment
calculations	procedure
choices	decision_making
corruption	dishonesty
gentility	elegance
fuzziness	opacity
awkwardness	unskillfulness
grabs	mechanical_device
assimilated	learn
odor	property
inspiring	stimulate
margaritas	cocktail
diversity	heterogeneity
arc	electrical_conduction
fluttering	wave
mojo	magic
are	area_unit
malik	leader
grace	state
came	travel
patience	good_nature
overplayed	act
visions	imagination
captive	unfortunate
arm	limb
kids	juvenile
retard	simpleton
stitch	sewing
art	creation
vice	evil
substances	matter
complications	hindrance
noticed	spy
bowel	internal_organ
dupe	person
favors	kindness
describes	set_forth
gobbler	eater
call	telephone
calm	disposition
ownership	relation
kick	blow
partners	domestic_partner
trumps	playing_card
ash	residue
ask	communicate
theories	explanation
intellectuals	person
animator	actor
stuffing	concoction
becoming	change_state
embarking	board
strength	property
rug	floor_cover
disregard	inattention
officer	serviceman
run	score
enact	decree
deviant	reprobate
reenacting	re-create
bomb	explosive_device
scrutinize	examine
rut	groove
mother	parent
view	orientation
oozes	matter
warriors	person
bicentennial	anniversary
cracks	opening
results	phenomenon
defiance	intractability
dust	particulate
bonanza	vein
correctness	quality
boll	capsule
taboo	bias
footage	film
bold	font
dares	challenge
camp	military_quarters
pranksters	troublemaker
instability	disorder
name	language_unit
spaces	attribute
justifies	confirm
bolt	lightning
neighborhood	section
stultifying	prove
benefits	payment
trotting	run
flakiness	insanity
mood	feeling
novelty	originality
boom	noise
pranks	folly
reflections	consideration
absence	lack
book	publication
truck	motor_vehicle
android	automaton
approaching	movement
edition	impression
generating	make
terrorizing	coerce
jockey	horseman
curio	object
kicking	motion
outs	failure
wattage	power
negative	denial
nonstop	flight
defend	argue
ally	state
boot	footwear
dotted	cover
screenwriter	scriptwriter
itch	infection
lulls	pause
sympathies	inclination
lavish	consume
introduce	inform
surrenders	despair
bone	connective_tissue
valentine	sweetheart
hijinks	merrymaking
bond	attraction
awe	wonder
editing	writing
momentum	force
target	reference_point
discourse	language_unit
malls	walk
mouth	rima
dystopia	state
giants	animal
assuming	expect
duty	social_control
yang	principle
ardor	eagerness
cape	land
yank	american
rye	grain
blazing	fire
leader	person
yard	linear_unit
trump	playing_card
dangers	condition
developers	creator
romanticization	idealization
iced	cover
collected	store
jonathan	eating_apple
discloses	tell
cast	gathering
piano	keyboard_instrument
slice	share
ravishing	assail
narc	lawman
broad	woman
serendipity	good_luck
princess	aristocrat
1960s	decade
elevate	delegate
cash	currency
case	happening
slick	smoothness
generation	people
cackles	cry
clinch	maneuver
images	representation
item	part
incoherence	disjunction
subscriber	supporter
surrealism	artistic_movement
musings	consideration
affections	feeling
downtown	city_district
matches	lighter
finesse	tact
auteur	film_maker
longing	desire
surrealist	artist
tunnels	passageway
swingers	athlete
cars	motor_vehicle
saving	action
sticks	implement
phone	electronic_equipment
slide	plate_glass
outshined	shine
failing	imperfection
matched	equal
flesh	animal_tissue
jungle	location
hairpiece	attire
card	paper
care	work
participation	group_action
assault	battle
damage	change
boss	supervisor
thievery	felony
lends	change
feminine	gender
portraits	word_picture
exercise	effort
underdogs	failure
disservice	injury
criticizes	comment
labour	class
scrape	noise
admirer	advocate
outselling	surpass
kilt	skirt
physics	natural_science
homosexual	person
dared	act
aptitude	ability
protect	defend
sportsmanship	fairness
scooter	motorboat
counterculture	culture
reliance	certainty
helpings	small_indefinite_quantity
infomercial	commercial
display	demonstration
heels	bottom
amours	sexual_relationship
kill	termination
freeman	citizen
distressing	trouble
year-end	end
bore	unpleasant_person
beings	state
reprieve	relief
astringent	medicine
painters	artist
yarn	report
costuming	dress
bout	part
spiked	banish
simple	herb
nighttime	time_period
smitten	hit
babysitter	keeper
weirdo	unpleasant_person
labors	class
talent	natural_ability
condescending	act
receding	disappearance
connections	relation
described	set_forth
negotiate	hash_out
rogue	villain
speculation	opinion
bots	larva
package	collection
king	sovereign
kind	category
timing	temporal_arrangement
tumult	disturbance
overburdened	charge
traces	small_indefinite_quantity
hyped	publicize
ouzo	liquor
spikes	electrical_discharge
affection	feeling
nerve	fiber_bundle
diversion	activity
affecting	change
reptilian	vertebrate
polemic	writer
inspiration	idea
bowl	vessel
theorist	intellectual
dilutes	weaken
diapers	garment
patient	case
sag	depression
phony	deceiver
traced	analyze
scripts	dramatic_composition
mentioned	think_of
depressing	discourage
sam	guided_missile
depiction	description
reincarnation	embodiment
amount	assets
move	decision
sap	solution
molehill	knoll
assignment	duty
album	medium
sat	weekday
yawn	reflex
alarms	fear
saw	saying
say	opportunity
sandwich	snack_food
enough	relative_quantity
increase	indefinite_quantity
spread	change_of_location
jived	dance
favor	kindness
heights	topographic_point
scuttled	run
malnourished	feed
latter	second
depression	psychological_state
clinic	medical_institution
treating	interact
bad	quality
switches	control
depraved	change
boys	male
bag	container
alienate	change
drags	resistance
reflected	indicate
awake	change_state
bai	tibeto-burman
kiss	touch
nazi	fascist
bar	room
suffer	experience
dynamite	explosive_compound
squint	abnormality
projector	optical_device
draft	negotiable_instrument
fluid	substance
resonate	sound
drowned	cover
playbook	notebook
harrowing	plow
mishmash	assortment
soaked	immerse
reopens	open
personal	news_article
personas	portrayal
angst	anxiety
delay	pause
lashing	beating
heyday	time_period
dean	academic_administrator
neophyte	plant
deal	transaction
abuse	mistreatment
eroticized	change
lobbyists	persuader
affect	feeling
icon	symbol
facing	lining
dead	people
proven	be
eyes	opinion
cleansing	improvement
ministers	clergyman
proves	academician
sea	body_of_water
drain	emptying
princesses	aristocrat
proved	be
slogans	saying
amuse	entertain
see	seat
tenor	singing_voice
sabotaged	disobey
responsibility	social_control
symbolism	symbol
sharpener	implement
dear	lover
poses	affectedness
omission	mistake
compared	analyze
completion	maneuver
frazzled	break
set	collection
sex	bodily_process
column	file
portent	augury
procedure	activity
biography	history
sample	example
practices	activity
battle	military_action
admiration	liking
pique	fabric
subcultures	social_group
tooled	drive
fighter	person
earnest	security
river	stream
craziness	insanity
bed	bedroom_furniture
beauty	appearance
beg	plead
deposited	fasten
beckons	gesticulate
african-americans	american
ben	mountain
dolman	jacket
bowling	game
resumes	summary
dummies	mute
welsh	european
labored	fight
bet	gamble
shipping	commercial_enterprise
astounds	surprise
advocacy	support
faded	weaken
metropolitan	archbishop
brainpower	intelligence
teasing	harassment
viva	examination
zeal	eagerness
mergers	consolidation
liveliness	activity
galled	irritate
articulates	supply
debt	indebtedness
fades	golf_stroke
little	small_indefinite_quantity
fluff	material
deer	ruminant
deep	middle
confined	control
killers	person
ballerina	ballet_dancer
forgive	concede
deem	see
exhibits	evidence
parade	procession
kurds	asian
getting	act
liking	feeling
verging	bound
lemon	citrus
salaries	regular_payment
appalling	experience
undermines	disobey
clears	innocence
instructs	inform
cobbled	pave
sin	unrighteousness
sip	swallow
confines	scope
pretensions	artificiality
conversion	transformation
over	part
ballot	document
wanderers	traveler
living	experience
six	digit
knickknacks	article
undermined	disobey
breathing	bodily_process
bound	line
tatters	piece_of_cloth
chuckles	laugh
football	contact_sport
resents	dislike
stroke	maneuver
frowns	facial_expression
endearing	please
selves	consciousness
setup	equipment
bid	speech_act
humans	group
astonish	surprise
manifestations	appearance
amazement	feeling
frustrated	prevent
mesmerizing	charm
convinces	persuade
advanced	travel
broomsticks	handle
improves	change
recommendation	advice
egomaniac	egotist
bit	small_indefinite_quantity
depicts	represent
thanks	acknowledgment
improved	change
biz	occupation
striking	happening
convinced	persuade
advances	change_of_location
imagery	representational_process
recognise	prize
modem	electronic_equipment
funniness	fun
model	hypothesis
animals	organism
sequel	result
dramaturgy	communication
conflicted	contrast
reduce	decrease
sky	atmosphere
afghan	blanket
screwed	copulate
surface	artifact
large	size
satisfied	meet
buffeted	strike
smoothed	change_surface
tomorrow	day
injects	administer
smoother	power_tool
practitioners	professional
compromised	agree
parrot	bird
template	model
viewer	perceiver
preferring	like
crystal	solid
weekend	time_period
prophet	diviner
sequences	series
bankruptcy	failure
distilled	liquefy
ingratiating	manipulate
finishing	decorativeness
mimics	impersonator
handicapped	people
inquiry	problem_solving
satisfies	meet
halftime	pause
viewed	think
nerds	learner
angle	space
immigrant	migrant
tradition	content
bastards	unpleasant_person
table	array
change	happening
extremes	degree
combustible	fuel
punishment	social_control
discovery	act
motions	visual_communication
sidekicks	friend
squirm	motion
estrogen	steroid_hormone
constant	quantity
angel	spiritual_being
office	place_of_business
northern	middle_english
anger	emotion
stands	support
fantasized	imagine
proceeds	income
son	male_offspring
encounters	fight
reviewed	analyze
portraiture	word_picture
discretion	liberty
hounds	hunting_dog
thrown	propel
throws	propulsion
fuelled	supply
bob	british_monetary_unit
rewarded	recognize
bod	body
enacted	decree
littered	be
venality	corruptness
contriving	create_by_mental_act
tense	grammatical_category
spy	secret_agent
reinvigorated	stimulate
behind	body_part
shades	spectacles
dozens	large_indefinite_quantity
tenth	common_fraction
box	container
tiring	devolve
sentiments	feeling
principals	debt
coheres	touch
bow	knot
boy	male
switch	control
murphy	root_vegetable
workshops	workplace
facial	cranial_nerve
ripper	murderer
unfortunate	person
missive	document
chance	possibility
nature	quality
recycling	use
throwback	organism
clerk	employee
frustrates	prevent
100	large_integer
awards	grant
pageantry	ceremony
heroine	character
tempting	invite
foundering	sinking
stance	position
boardwalk	walk
wobbly	radical
repartee	wit
handles	appendage
occurrences	event
dancing	diversion
boatload	large_indefinite_quantity
stoop	inclination
counts	number
county	region
buried	hide
paint	coating
plunges	swimming
pains	attempt
fighting	conflict
ponder	think
tunisian	african
endear	please
improvisation	creation
democracies	political_orientation
bra	undergarment
dynamics	mechanics
unravels	undo
scandal	gossip
heroism	courage
friend	person
flattens	shape
draws	gully
buries	hide
drawn	move
societies	social_group
heartache	sorrow
deny	contradict
tissues	body_part
pleasure	feeling
invokes	make
convolutions	round_shape
glory	honor
120	large_integer
morning	time_period
secondary	formation
horse	equine
actors	performer
mission	nongovernmental_organization
stops	card_game
extremist	radical
conditions	context
daytime	time_period
lessons	teaching
sub	sandwich
dosage	indefinite_quantity
enhances	intensify
emulates	imitate
dungeons	stronghold
sum	assets
grounded	fasten
stallion	male_horse
defecates	excrete
extended	increase
serving	small_indefinite_quantity
current	electrical_phenomenon
resorting	use
secretary	head
majors	league
managed	succeed
gloom	semidarkness
moulds	soil
misfires	breakdown
participants	associate
cartons	containerful
offensive	operation
storm	atmospheric_phenomenon
manager	administrator
cartoon	wit
texture	tactile_property
overworked	work
manages	succeed
makes	kind
maker	creator
strangling	suffocation
threatened	exist
enemies	military_unit
store	mercantile_establishment
tickled	itch
honoring	conformity
beloved	lover
paralyzed	inactivate
bug	insect
handled	control
amir	ruler
depths	extent
tickles	cutaneous_sensation
earmarks	marker
instincts	aptitude
story	message
detriment	damage
bravura	virtuosity
buy	purchase
express	mail
garner	storehouse
deconstruction	philosophical_doctrine
interviews	interrogation
zero	relative_quantity
cheered	encourage
requiem	song
excesses	overabundance
austerity	self-discipline
seizures	attack
distinctions	discrimination
written	create_verbally
generate	make
passion	feeling
fills	enough
tuck	comestible
publicists	communicator
films	product
tapestry	complexity
greatness	importance
dealers	merchant
drizzle	rain
enhanced	intensify
desecrations	irreverence
tube	conduit
ocean	body_of_water
horns	noisemaker
heavyweight	boxer
idea	content
unfolding	development
adults	person
ballplayer	athlete
prisoners	unfortunate
shelves	support
meatballs	dish
flush	time_period
jettisoned	discard
stomp	social_dancing
mortal	causal_agent
lovely	photographer
normal	practice
skulls	bone
figure	illustration
encourages	support
damsel	maid
calories	work_unit
storylines	plot
stone	natural_object
rousing	change_of_state
zest	enjoyment
motifs	design
booths	table
baffling	confuse
passing	football_play
sack	bag
streets	thoroughfare
tested	evaluate
humility	trait
christianity	religion
bluffs	bank
hack	unskilled_person
seconds	time_unit
retiring	leave_office
children	juvenile
road	way
review	appraisal
wrath	fury
buffs	follower
nobody	commoner
guide	escort
tenet	religious_doctrine
spectacle	sight
ethnic	person
efficiency	ratio
goal	content
natural	achiever
highlander	soldier
arising	become
sleekness	appearance
comprehension	understanding
improvised	perform
scares	anxiety
meanderings	travel
eschews	avoid
whitewash	defeat
acquainted	inform
sensitivity	sense
verve	energy
scared	stimulate
racing	sport
flag	emblem
seasonal	worker
freight	merchandise
range	extent
stylists	artist
rode	travel
snagged	hitch
derive	reason
rock	natural_object
flaw	imperfection
feature	property
screens	surface
flat	plain
recall	request
climax	juncture
penchant	liking
brazen	defy
irrational	real_number
1970s	decade
sickening	repel
haphazardness	irregularity
emailed	telecommunicate
twisted	move
gymnastics	sport
suggest	declare
uncovers	show
filter	device
emotion	feeling
twister	cyclone
prescription	direction
elements	weather
spectator	perceiver
responses	consequence
behaviour	action
raunch	inelegance
apology	acknowledgment
argument	evidence
villain	unwelcome_person
hopeful	applicant
lyricism	musicality
cooks	skilled_worker
annoyances	psychological_state
dozen	large_integer
sags	depression
growing	organic_process
follow-up	work
tad	small_indefinite_quantity
suspending	hang
verse	writing_style
campfire	fire
saga	adventure_story
clothed	change_state
hallmark	characteristic
centuries	time_period
tap	sound
tar	bitumen
goes	shift
bouquet	flower_arrangement
tax	levy
wraps	cloak
lovers	person
tay	tai
ranks	line
chances	possibility
slipperiness	smoothness
safe	strongbox
overstays	bide
destined	ordain
departure	act
favorites	choice
sportsmen	athlete
covering	natural_object
instances	happening
cad	villain
flee	scat
tune	music
skidding	skid
can	container
drama	dramatic_composition
hair	body_covering
award	grant
car	motor_vehicle
marriage	marital_status
floating	swimming
cat	feline
fluke	luck
said	express
bouts	part
cabins	compartment
laziness	inactiveness
smooth	accomplishment
carried	move
tailor-made	clothing
racism	bias
motion	visual_communication
satisfy	meet
plight	difficulty
fault	nonaccomplishment
interplay	interaction
hail	precipitation
distracted	confuse
bites	wound
passive	voice
clothes	clothing
monsoon	wind
carrier	traveler
fragment	part
carries	transportation
detractors	cynic
refreshing	remember
response	consequence
counterparts	equivalent
cooly	asian
shakespearean	scholar
dynamism	doctrine
arguments	evidence
shreds	small_indefinite_quantity
racist	bigot
category	collection
rival	contestant
tends	be
throes	suffering
